Vejolaš derivašuvdna bargobihtát:
---------------------------------

1) resiproka:
---------
suhttat -> suhtadit
eaddut -> eattudit
soahpat ->  soabadit
deaivat -> deaivvadit
hupmat -> humadit
liikot -> liikodit
čuorvut -> čurvvodit
gávdnat -> gávnnadit
láhppit -> láhpadit

álgit -> álgalit
heaitit -> heaitalit
oaidnit ->  oaidnalit
náitit -> náitalit
riidit -> riidalit

bealkit -> bealkkašit
vávjit -> vávjjašit

lonuhit -> lonuhallat
gulahit -> gulahallat

2) diminutiiva
borrat -> borastit
čállit -> čálistit
bassat -> basastit


3) kausatiiva
bargat -> barggahit
čállit -> čálihit
borrat -> borahit
nohkkat -> nohkahit


4) kontinuatiiva
vuodjat -> vuojadit
lohkat -> logadit
vuordit -> vuorddašit
vuodjit -> vuojašit
vázzit -> váccašit 
bossut -> bosodit

