bahkasidh	V	bli slitt av	åa4
bealloeaaltoe	N	bjøllesimle	åa4
boelvedidh	V	knele	åa4
bovvehtjidh	V	drepe; myrde; drepe flere	åa4
bæjngolsvaarjoe	N	yttertøy	åa4
deereriepie	N	hanrev	åa4
dejpeli	Adv	før i tiden; i gamle dager	åa4
doeltijehtedh	V	få til å koke opp	åa4
dåvvomesijjie	N	verksted	åa4
dæjpeles	A	brukelig; god å ha	åa4
fearkasidh	V	renne	åa4
hojhkesjidh	V	rope; skrike; rope til	åa4
håagkhstaavra	N	fiskestang	åa4
hååkene	A	hugen; lysten på; glad	åa4
hïngse	N	lyng	åa4
hïngsedålle	N	lyngbål	åa4
jyörtedh	V	oppholde seg	åa4
naatskedh	V IV	gyve på	åa4
njööredidh	V	renne ut	åa4
noerhtelistie	Adv	fra nord	åa4
onterdidh	V	undres; fundere; undre; undre seg	åa4
raajsedh	V IV	sprekke; slå sprekke	åa4
raejrienvearelde	N	tordenvær	åa4
riepieråaksoe	N	hunrev	åa4
rïgkesjidh	V	klinge	åa4
skaadtje	N	fark; larv; skarv	åa4
smalhtjaridh	V	gå i stykker	åa4
snaabrestidh	V	nappe litt som snarest	åa4
speedtjedh	V	spre reinsdyr; spre reinhjord; spre beitdene dyr; spre	åa4
staavra	N	stang	åa4
svïhtjedh 	V IV	røre seg; bevege seg	åa4
sæjloedidh	V	gjøre sliten; forårsake at en annen blir trett; gjøre trett	åa4
tjoejenesguhpie	N	lydpotte	åa4
voessjehtjidh	V	holde på å koke	åa4
våårenjasse	N	ulv; rovdyr	åa4
ålloe	N	ull	åa4
ålloetråajja	N	ulltrøye	åa4
ålvoes	Adv	forferdelig	åa4
laabjehtidh	V	labbe med bløte sko	åa6
låssas	Adv	på liksom	åa6
miehtjiebasse	Adv	lenger bakom	åa6
minngehke	N	baktroppen; bakre del av reinflokken	åa6
måskoes	A	lukket; sammensydd; innestengt	åa6
mïevhkes	A	mjuk; mjuke	åa6
na	Adv	nokså	åa6
nille	Po	oppå	åa4,åa6
njoere	A	saftig	åa6
nåtsh	Adv	hvordan	åa6
pleaksjode	Adv	bar på hals og bryst	åa6
pleentege	N	blanding	åa6
reavsa	N	lymfeknyte; itle	åa6
reehkedh	V VI	rake; karre	åa6
reektehts	N	rapport	åa6
saalhtetje	N	litt salt	åa6
saarnoeh	Interj	hva i all verden	åa6
saemiedigkie	N	sametinget	åa6
sarhvegidh	V	flise opp	åa6
sinsitnie	Pron	seg i mellom; hverandre	åa6
sisnjelen	Adv	innenfor; på innersiden	åa6
sjeavodh	A	stille; tyst	åa6
sjilkehtimmie	N	smeltet	åa6
sjovnestidh	V	være tjenestejente	åa6
sjyjjesjidh	V	gjøre jevn; gjøre flat	åa6
sjïjlelaejpie	N	globrød	åa6
sjöövelidh	V	røre om; røre sammen i en fart	åa6
sjöövememielhkie	N	kjernemelk	åa6
skaale	N	skall	åa6
skeenedh	V VI	slikke	åa6
skylledh	V V	gå til alters; gå for presten; konfirmeres; gå til konfirmasjon	åa6
skååffedh	V V	skaffe	åa6
skïhpe	N	skip	åa6
sleebpedh	V VI	slå ut; helle ut	åa6
sleejedh	V VI	slå gras	åa6
slïekte	N	slekt; slektning	åa6
slyöbpedh	V V	slippe	åa6
slåavege	N	ris; stryk	åa6
soeke	N	mark; larve	åa6
sojjehtimmie	N	bøyning	åa6
soptsestæjja	N	forteller	åa6
sovhkedh	V IV	ro	åa6
spaenjietsåaka	N	grunne med svaberg	åa6
sperniedidh	V	sparke og stritte imot	åa6
staehkie	N	høystakk	åa6
straavedh	V IV	være bekymret; nære mistanke; nære tvil	åa6
stråmhpoeraedtie	N	kanten av busk og kjerr	åa6
stïelhke	N	stengel	åa6
stöörelgovvedh	V	bli forstyrret	åa6
suvtie	N	bukkeblad	åa6
såakelgidh	V	begynne å bli tykk om melk	åa6
såekiegalte	N	bjørkekubbe; bjørkestokk	åa6
sååkesjidh	V	sage	åa6
sååketje	N	tette	åa6
sååketjekraesie	N	tettegras	åa6
sïerke	N	vier; vidje	åa6
söökesmielhkie	N	tykkmelk	åa6
tjaalaldihkie	A	ferdigskrevet	åa6
tjaalesthtjomhpe	N	stavelse	åa6
tjaktjege	Adv	om høsten	åa6
tjeapetji	Adv	varsomt	åa6
tjohpetje	N	lite gruppe	åa6
tjæjodh	V II	få forstoppelse; ha treg mage	åa6
tjöönghkedh	V	samle; sanke; plukke	åa6
tovme	A	tom	åa6
tråjjadidh	V	trives	åa6
trïengkestidh	V	 være dreng	åa6
tröjjeste	X	vondt i magen; diarè	åa6
tsoepkenidh	V	brekkes av; gå i stykker	åa6
tsåaka	N	grunne; der det er grunt	åa6
tæhtjoe	N	hustak	åa6
töölledh	V VI	tåle	åa6
ujkierdidh	V	ule	åa6
veahkaetihke	N	hjelpsom	åa6
veajalidh	V	falle om; falle til siden	åa6
vealah	A	liggende på siden	åa6
vealmetje	N	lite stilleflytende dypt sted i en elv	åa6
vihkeles	A	viktig	åa6
vihtehke	A	klok; forstandig	åa6
voejedallie	N	smørdall; smørbutt	åa6
vuekielïhtse	N	måtesledd	åa6
vïekesjidh	V	veie	åa6
vïelletjh	N	brødre innbyrdes	åa6
vïenes	A	vennlig	åa6
åahpenadtedh	V IV	bli kjent med flere	åa6
åredh	V I	sove	åa6
ååjmedidh	V	formå; kunne; makte	åa6
ååjretje	N	liten åre	åa6
ååjsehtalledh	V IV	måtte gi seg over; gi opp på grunn av tretthet	åa6
