aabpelsijna	N	appelsin	s4
aabpelsijnejuvse	NX	appelsinjuice	a1
aadtjegh	Adv	nylig; nettopp	s2,s3,s4,åa2
aadtjen	Adv	nettopp	åa5,åa2
aagkele	N	mellomgulv	s3
aahka	N	bestemor; eldre kvinne	s1,s3,dej,åa5,åa2,a1
aahkove	N	barnebarn (til aahka); barnebarn til bestemor	a1,åa2
aaj	Adv	også	s1,s2,s3,åa2
aajahtalledh	V	tenke; grunne	s4
aajhtsedh	V IV	bli var; legge merke til; oppdage	s4
aajja	N	bestefar	s3,dej,åa2,a1
aajjove	N	barnebarn (til aajja); barnebarn til bestefar	s4,dej,åa5,åa2,a1
aajjuve	N	barnebarn til bestefar	s3
aajkoehkadtjh	N	søskenbarn (innbyrdes); kusiner (innbyrdesgjelder søskenbarn av begge kjønn); fettere (innbyrdesgjelder søskenbarn av begge kjønn)	åa2
aajkohke	N	søskenbarn; fetter (gjelder søskenbarn av begge kjønn); kusine (gjelder søskenbarn av begge kjønn)	s2,s3,s4,dej,åa2
aajmene	Adv	igjen; i behold	åa5
aajroe	N	åre; spor etter reinflokk; flyttveg	dej,åa2,åa5
aaksjoe	N	øks	dej,åa5,åa2
aalkoe	N	begynnelse	a1
aalkoekuvsje	NX	begynnerkurs	a1
aalkove	N	begynnelse	dej,åa5
aaloe	N	saft	s4,a1
aaltoe	N	simle	s2
aamhtese	N	sak; emne	s4
aamhtesegïetedallije	N	saksbehandler	s4,a1
aanja-soene	NX	sene på fremsiden av reinens bein	dej
aareh gïjre	AX	tidlig vår	s4
aarhskuvlelohketæjja	NX	førskolelærer	a1
aarpije	N	enke; enkemann	dej
aate	N	ting; dele; eiendel	s3,a1
aatedh	V IV	gjøre; tenke å gjøre noe	a1
aatovmefaamoe-sijjie	NX	atomkraftverk	s4
aatskadidh	V	forsøke; prøve; sette igang; gi seg i kast med; drive iherdig med	s2,s3,dej
aatsolen	Pr	over	åa5
aavhtestidh	V	øse (vann ut av båt)	åa5
aavoe	N	glede	s3,s4
aavrehke	A	heldig	s3,s4
aavtjoe	N	egg (på kniv eller øks)	s4
abpe	Indef	hele	s1,s2,s3,åa5,åa2
abpese	N	genser	s1,a1
abrodh	V II	regne	dej
aehtjaahka	N	farmor; bestemor (fars mor)	åa2
aehtjaajja	N	farfar; bestefar (fars far)	åa2
aehtjie	N	far; pappa	s2,åa2,a1
aejkie	N	gang	s2
aejlege	N	søndag	a1,dej,åa2
aejmie	N	skjærnål	åa2
aelhkie	Adv	lett; lettvint	s2
aelhkies	A	lett; lettvint
aelkedh	V I	begynne	s1,a1,dej,åa5
aellieh	X	ikke (du)	s2
aelmies	AX	god; kraftig kjøttsmak	s3
aelties	A	takk	a1
aerebi	Po	før	s1,s2,s3,dej,åa5
aerebi	Pr	før	s1,s2,s3,dej,åa5
aerede	N	morgen	s1,s2,dej,a1
aeredh	V	hindre;hefte	a1
aeredsbeapmoe	N	morgenmat; frokost	a1
aerie-bielie	NX	hårside av barket skinn	dej
aeriebistie	X	fra tidligere	s1
aerkies	A	redd; fryktsom	s3,s4
aerviedidh	V	anta; forstå; ane; anslå	s2,s3
aevere	X	ikke noe særlig	s3
aevlerge	N	gryteås; tverrstokk mellom otnerassh	s4
aevsie	N	gevir; hornkrone (hjernepannen med hornene)	dej,åa2
ajve	Adv	bare	s2,s3
akte	Num	en; ei; ett	s1,s2,dej,åa2
aktine	Po	sammen med	s2
aktine	Pr	sammen med	s2
almetje	N	menneske	s1,s2,s3,dej
almetji ektesne	X	sammen med mennesker	s2
altese	N	bjøre; overstykke (på fremre del av en sko)	dej
altese	PersX	hans; hennes; deres; sin; sine	s2,s3,dej
alvas	Adv	forferdelig; alvorlig	dej
amhkedh	NX	tungt og trykkende vær	s3
amma	Pcle	jo; jo visst; altså; virkelig; sikkert; sannelig	s3,åa5,a1
ammes	A	fremmed; ukjent; fjern	s2,s3
annje	Adv	ennå	s1,s2,åa5,åa2
arhpehtovvedh	V	bli kjed; ergerlig	s4
aske	N	måne; måned	s3,dej,a1
askedibie	N	måneskinn	dej
assh dohkoe	InterjX	gå vekk (til hund)	s1
astedh	V IV	ha tid til noe	s1,s2,dej,åa5
astoe	N	god tid (til noe)	s1
asvedidh	V	føle uhygge; angst; redsel	s4
baahke	N	varme; varmt vær	dej
baahkenidh	V	bli varm	dej
baahkes	A	varm	s3
baahkestjaetsie	NX	varmtvann	a1
baahketjaetsie	NX	varmt vann	åa5
baahkoe	N	fjellside	dej
baahtje	N	gutt; ungkar; smågutt	a1
baahtsedh	V IV	slippe fram; smelle; gå av (om et skudd); komme over (f.eks ei elv); komme løs	dej,s2
baahtsege	N	dyrehjerte; kongle; pung på grarein	s4
baajedh	V IV	la; la være	dej,åa5,åa2
baajkoe	N	sterk kulde	s3
baajnedh	V IV	trekke seg inn; ta farge	dej,s3
baakoe	N	ord; uttrykk	a1
baakoelæstoe	N	orliste	a1
baaktoe	Po	ved; om; via; forbi	s2,dej
baaktoe	Pr	ved; om; via; forbi	s2,dej
baalhka	N	lønn	s4
baalhka	NX	stang; klessnor (for å henge noe på)	dej
baalte	Po	ved siden av	s2
baanghke	N	bank	a1
baarhkoe	N	bark	s4,dej,åa2
baarhkoe-galte	NX	barkkubbe	åa2
baarhkoe-laaje	NX	barklaug	dej
baarhkoe-voesse	NX	barkesekk	dej
badth	Pcle	da; ja; nok; virkelig; altså	s1
badtja	N	smurning; salve (medisin)	s4
badtjadidh	V	smøre (skoskinnski)	s4
baejhtedh	V I	jage på; drive (f.eks rein)	dej
baeledh	V I	grave; måke unna snø; gjøre rent; ha ut gammel ris og koste vekk rask	a1,dej,åa5
baenie	N	tann	s3,dej,åa5,a1
baenie-dåaktovre	NX	tannlege	dej
baernie	N	gutt; sønn; kjæreste 	s1,s2,dej,a1
baetjkere	N	kart; bærkart	s3
baetsedh	V I	bli igjen; bli etter	s3,dej
baevtie-guedteme	NX	den tid da de fleste kalver fødes	dej
baevtie-skïeredahke	NX	den mest aktive parringstiden (ved Mikkelsmesse 24.sept)	dej
bahte	N	baken (på menneske)	s3
balhka	N	knapp	a1
baltehke	N	spøkelse; skrømt	s4
balve	N	sky	dej
bangseme	N	leppe	s3,s4
barkedh	V IV	arbeide	s2,s3,a1,dej
barkije	N	arbeider	a1
barkoe	N	arbeid	s2,s3,s4,åa2,a1
batjka	N	spæl; hale på rein	dej
beagkoes	A	vindfullt	s2
bealesne	Po	ved siden av	s1,s2,s3
bealesne	Pr	ved siden av	s1,s2,s3
bealloe	N	bjelle	s3,dej
beapmoe	N	mat	s1,s2,s3,dej,åa5,åa2,a1
bearjadahke	N	fredag	a1
bearkadidh	V	berge seg; klare seg	s1,s2,s4
bearkoe	N	kjøtt	s1,s2,s3,åa5
bearkoe-snaejrie	NX	kjøttskive	dej
bearkoeh	NX	kjøtt; kjøttstykker	dej,åa2
bearkoeh-krovhte	NX	kjøttgryte	s3
bearkoejoptse	NX	kjøttsuppe	s2
bearkoekrovhte	N	kjøttgryte	s2
beelhte	N	belte	dej,åa2
beenghkedh V VI	banka; slå;knakke	s4,dej
beensine	NX	bensin	s3
beere	N	bjørn	dej
beetnege	N	pengestykke	dej
beetnegh	NX	penger	s2,s3
bejsjeme-moere	NX	stokk som går fra ildstedet til døra	s4
beltedh	V I	skremme; avskrekke; skremme bort	dej
berkedh	V	I	grave og rote etter noe	a1
berkiestidh	V	stige opp (om røyk)	dej
bertedh	V I	stable opplegge i hauger	s4
betnie	N	rein som blir stående igjen i hovedgjerde etter skilling; bunn; botn	dej,s4
betniegierkie	NX	bunnstein	s4
biehkie	N	stykke; del; bit; ting	s3
biejjegi	AdvX	om dagene	s2
biejjeste	X	fra dagen	s2
biejjie	N	dag; sol	s2,s3,dej,åa2,a1
biejjiebaerehke	NX	solstek; solside	s4
bielie	N	halv	s1,s2,åa2
bieljie	N	øre	s3,dej,åa2
biessie	N	never	s3,dej
biestedh	V I	slippe; miste fra seg; miste fisken fra kroken	dej
biestielidh	V	miste	s4
bietskiedidh	V	klippe til; skjære til	dej,s3
bigkedh	V VI	bygge	s2
bijjelen	Po	over; forbi (om tid)	s1,s2,s3,dej
bijjene	Adv	oppe	s2
bijjie-rietjmie	NX	øvre telne (på fiskegarn)	åa5
binhtedh	V VI	gjøre rentrydde opp (f.eks etter slakt)	s4,dej
bissedh	V I	stekke; brenne	dej,s4
bissie	N	never	s4
bist	Pcle	nå; igjen	a1
boehth	Po	midt imot; rett overfor	s2
boelhketje	N	en liten stund; liten avstand	dej
boelte	N	skog; li; vegetasjonsområde med løvtrær	s4
boelve	N	kne	s3,dej
boengeskuvmie	NX	barmklede	åa2
boerehks	AX	gavmild; godhjertet	s3
boetje	N	kjønnsorgan (mannlig)	s3
boevedh	V IV	være oppe om natten; holde leven	s4
bovre	N	butikk	s1,s2,åa5,åa2,a1
bovtse	N	rein; reinhjord	dej,s2,åa2
bovtse-almetj	NXe	reinskar	dej
bovtsi gåajkoe	X	til reinskogen; til reinene	åa2
bovtsi-luvnie	X	i reinskogen; hos reinene	dej,s3,åa5
brorredh	V IV	bråke; lage vibrerende lyd	dej
buajtehke	A	fet	s4
buarastehtedh	V	hilse; håndhilse	s4,dej
buaregh	Interj	god dag (sies ved håndhilsen); takk for sist; vel møtt; godt møte (sies ved håndhilsing)	dej,s1,s2,a1
buejtie	N	spekk; fett	dej
buektedh	V I	bringe; komme med; sette frem; tilføre	s3,s1,dej,åa2
buektiehtidh	V	kunne; greie; makte; få seg til (å gjøre); få til (noe)	s2,s4,åa5
bueledh	V I	brenne; svi(etter insektbitt); lyse (om nordlys)	dej
buerie	A	bra; god	s1,s2,s3,s4,dej,a1
buerie	NX	velgjerning	s1,s2,s3,s4,dej,a1
buerie aerede X	god morgen	s1
buerie biejjie X	god dag	s1
buerie iehkede X	god kveld	s1
buertie	N bord	s3,dej,a1
buhtjedh	V I	melke	dej
buhtjiedidh	V	vri opp	dej
burredh	V I	spre ( f.eks reinulvhund); legge utover (f.eks blader)	dej
busse	N	buss	s1
buste	N	skje	s3
bustetje	N	liten skje	a1
butnedh	V I	spinne; tvinne	dej
buvrie	N	bur; stabbur	s1,s2,åa2
buvvedh	V I	drepe	dej
byjreskistie X	fra området	s3
byöpmedidh	V	spise	s1,s2,s3,dej,åa5,a1
byöredh	V V	burde; behøve; måtte; skulle	dej
båadtsode	Adv	naken; uten klær	s3
båatsoe-almetjh	NX	folk som er sammen med reinen	s3
båatsoeburrie	N	reineier	s2,a1
båatsoesaemie	NX	reindriftssame	s2
bådtjadidh	V	smøre; impregnere	dej
båeltedh	V I	brenne(noe); bite (i ansiktetom hardt vær); brenne 	dej
båeltielidh	V	brenne opp	åa5
båeries	A	gammel	s1,s2,s4,dej,åa2,a1
båervie	N	fett; talg ( kokt eller oppvarmetogså kaldstørknet)	dej
båetedh	V I	komme	s1,s2,s3,a1,dej,åa5,åa2
båetije bearjadahken	AX	førstkommende fredag	s4
båetskie	N	hæl	s3
båetskie-soene	NX	hælsene	dej
bårrestohtedh	V	sulte; bli sulten	s3
bårrestovvedh	V IV	bli sulten	dej
båvne	N	åsrygg (som er treløs på toppen); lavt snaut fjell omgitt av skog	dej
bååhkesjidh	V	bake	s1,dej
bååktjehke	A	er vond	s3
båårhkeldh	X	barket; garvet	dej
båårhkesjidh	V	barke	dej
bååstide	Adv	tilbake	s1,s2,s3,a1
bægkah	NX	proviant; reisegods; oppakning	dej
bæhta	N	bit	dej
bæhtoe	N	bøtte	s3
bæjjes-våårte	AdvX	oppover (mot fjelletvårflytting)	s4
bæjjese	Adv	oppover; opp	dej,åa2,åa5
bæjngolen	Adv	på yttersiden	åa5
bïegke	N	vind	s3,dej
bïejedh	V IV	legge; sette	dej,a1,s2,s3,åa2
bïejkelidh	V	vrikke (fotarm)	s3
bïeljelidh	V	fortelle (noe i en fart)	s3
bïenje	N	hund	s1,s2,dej,åa2,a1
bïerkenidh	V	klare seg; berge seg	s2
bïevestohtedh	V	svette; bli svett	s3
bïevle	N	barflekk	s4
bïevledh	V IV	bli snøbart	s4
bïevsterh	NX humør; lynne	s4
bïhkedidh	V	undervise; rettlede; forklare	dej,åa5
bïhte-moere	NX	den nederste spilen som en setter fast i skinnet (reinskinn)	dej
bïjle	N	bil	s1,s2,dej,åa2,a1
bïjlebovre	NX	bilbutikk	s2
bïjlevuejeme-lohkehtæjja	N	kjørelærer	s1
bïjre	Po	om; angående	s2,s3,åa5,a1
bïjvedh	V IV	være varm	s1
bïjveles	varmt	s1,s2,s3,s4.dej,åa2
bïksedh	V IV	gripe fatt i; ta	dej
bïlledh	V IV	være redd; frykte	s2,s3,dej
bïllijidh	V	bli redd	dej,åa5
bïssedh	V IV	vaske	a1,dej,åa5,åa2
bïssedidh	V	vaske seg	s3,a1
bööredh	V VI	by; innby	dej,s3
bööresovvedh	V	bli bedt; bli bedt til	s3
böötedh	V VI	bøte; betale bot	dej
daablodh	V II	spille brettspill	a1
daabloe	N	brettspill	a1
daabloebaakoe	NX	spilleord	a1
daabloehtæjja	NX	spiller	a1
daagkoe	Adv	her	åa5
daajroes	A	det vite	s4
daaletje	Adv	nå for tiden	dej
daalhkesh	N	medisin	s2
daamtaj	Adv	ofte	s3
daan aereden	X	i morges (denne morgenen)	s2
daan biejjien	X	i dag	åa2
daanhtsodh	V II	danse	s4
daarhve	N	flekk	dej
daaroengïele	NX	norsk språk	a1
daaroestidh	V	snakke norsk	s1
daarpesjidh	V	trenge; behøve	s2,s3,s1,dej,åa5,a1
daase	Adv	til hit	s3
daate	Dem	denne (like ved); dette (like ved)	s1,s2,åa2,a1
daatoe	N	dato	a1
dabranadtedh	V	henge seg fast til stadighet
dabranidh	V	bli hengende fast; feste seg (til noe); sette seg fast	s2,s3
daebpene	Adv	her borte	s3
daebrie	N	milten	s3
daejnie	X	med denne	s3
daejredh	V I	vite	dej,a1,s2,s3,åa2
daejtie	X	disse	s1
daelhkie	N	føre; vær	s3,s4
daelie	Adv	nå	s1,s2,s3,a1,åa5,åa2,a1
daelvie	N	vinter	s4,dej,åa5
daemies	A	tam	s2
daen biejjien	X	i dag	s1,s2
daerpies	A	nødvendig	s1,s2,s3
daesnie	X	her	s1,s2,s3,åa5,åa2
daeverh	NX	ting	s2
dagkarinie	AX	slik; slik som den	s2
dagke	Pcle	så; jaså; vel (spørreord)	s2
dagkeres	A	slik; slik en; slik som den	s2,s3
dagkoe	Adv	der	dej
dah	X	de	s1,s2
dah guaktah	X	de to	s2
dahkoe	Adv	dit; dit hen; dit over	s1,s2,åa2
dahpe	N	slire	åa2
dajve	N	område; trakt; strekning; egn	a1
dallah	Adv	straks; med en gang; så snart som	s1,s3,dej,åa5
dallatjinie	Adv	med en gang; straks	s4
dallegh	Adv	straks	s2
dalvedh	V IV	komme; komme til syne	dej
dalvese	N	fjellkam ( mot horisonten)	dej
damhkedh	V III	komme til rette; komme til syne	dej
damtedh	V IV	kjenne; føle; smake på	s2,s3,dej
dan	X	så	s2
dan soe	X	alldeles	åa5
darhke	Pcle	slik; så; virkelig	s3
darjodh	V II	gjøre; lage	s2,dej,s3,åa5,åa2,a1
darjome	N	gjøremål	dej
darvedh	V IV	tjærebre	åa2
darvodh	V II	tjærebre	dej
dassedh	V IV	miste	dej
datne	Pers	du	s1,s2,s3,dej,åa5,a1
deahpadidh	V	hende	s4
deakehke	N	gammestang; teltstang	s4
dealodh	V II	dekke bord	s4,a1
dealoe	N	duk; underlag for å servere mat på	dej
deava	N	bakke; haug	dej
debpene	Adv	der borte	s2,s3
deejedh	V VI	legge utover	dej
deejehtidh	V	legge skohøy til rette i skoen	s4
deere	N	hannhund; hannrev; hannulv	dej
deerpegh	NX	fornødenheter; mat; utstyr(som er nødvendig; pengemidler (i mindre målestokk)	s2,s3
dej luvnie	X	hos dem	åa2
dej voessi sïjse	X	inn i de sekkene	s2
dej åvteste	X	for dem	s3
dejnie	X	med den	s3
dejpeladtje	A	gammeldags; som er fra før i tiden	dej,s4
dejpeli	Adv	før i tiden	s4
dejtie	X	de	s3
dellie	Adv	da; den gang; så; derpå	s1,s2,a1,åa2
dellie maajetjh	X	heldigvis; nå endelig	åa5
derhviegåetie	N	torvgamme	s4,åa5
desnie	X	der	s1,s2
destie	X	derfra; fra det	s1s3
dibrehtidh	V	feste; henge på	s3
diedtedh	V I	tynge på; trykke ned; trykke sammen	dej,s4
diekie	Adv	hit	s1,s2,s3,a1
dievhtedh	V I	fylle	s3,s4,dej
dievhtestahke	X	fyll; fyllmasse	dej
dieviedidh	V	treffe	s4
dih	X	de (kortform av dijjieh)	s2
dijjieh	X	dere	s2,dej
direktööre	N	direktør	a1
doekedh	V IV	selge	s2,s3,a1,dej,åa2
doekije	N	selger	a1
doekoe	Adv	utover (om tid)	åa2
doeltedh	V IV	koke (om grytevannkjøtt)	s3,s4
doeltehtidh	V	få til å koke; la koke	a1
doengedh	V IV	lappe; bøte	dej
doeredh	V IV	dra; dra opp (garn)	s3,åa5
doerke	N	kåteris	s4
doerkestidh	V	legge ris på jordgolvet i gammen	åa5
doestedh	V IV	våge; tore	dej,s2
doete	Dem	den; det der (nærmere deg)	s2
dohkoe	Adv	dit bort	s3
dohte	Dem	han; hun; den; det der borte (fjernere)	s1,s2
domtedh	V V	kjennes	dej
don biejjien	X	forrige dag	s2
dotnele	N	skinnet på undersiden av reinens hode	dej
dov	X	din; ditt	s2
dovne	Adv	til og med; endog; også; helt; alt; også; både	s3,åa5
dovres	A	dyr (om pris); dyrt	s1,s3,s4
dovtesgierkie	X	støttestein	s4
duakan	Po	bakom	dej
duakan	Pr	bakom	dej
duarsta	N	torsdag	a1
duarsta-biejjegi	X	om torsdagene	s1
dubpene	Adv	der borte	s1,s2,s3
dubpiebasse	X	lenger bort	s3
duelie	Adv	se der; vær så god	s3,åa5
dueljie	N	reinskinn med hår	dej,s3
dulvies	A	som er i flom	s2
dunnie bealesne	X	der borte på den andre siden	s2
dusnie	X	der; der borte	s1,s2,åa5
dutnjien	X	til deg	s3
duvhties	A	tett	s4,dej
duvhties-laakan	X	på en tett og kompakt måte	dej
duvlie	Adv	se der; der (har du)	s3
dåajodh	V II	skjære ris; skjære bar; brekke; bryte	dej,s4
dåaktere	N	doktor	a1
dåalvodh	V II	forfølge; sette etter for å nå	dej
dåaresth	Po	tvers over; på tvers	dej
dåemiedidh	V	oppføre seg; bære seg ad	dej,åa5
dåeriedidh	V	følge; bli med; være med	s1,s3,s4,dej,åa5
dågka	N	tobakk	s2
dålle	N	varme; ild	s3,dej
dån	X	du (kortform av datne)	s2
dåtnoeh	X	dere to	s1,s2,dej
dåvna	N	pute; hodepute	dej
dåvne-tråajjoe	X	dunjakke	s3
dåvvese	Adv	langt ut fra land; ut mot kysten	åa5
dåvvodh	V II	repareregjøre istand; kastrere	s3,s4,dej
dååpmehke	N	ørret	s2,s3,åa5
dæjman	Adv	i fjor	dej,åa5
dæjsta	N	tirsdag	a1
dængkodh	V II	tinge; bestille	s1,s3,dej
dïevedh	V IV	fylles; bli full	dej
dïeves	A	full av	s4
dïhte	Pers	han; hun; den; det	s1,s2,dej
dïjmedh	V IV	bli mør; koke mørt	s3
dïjnehke	N	sukker	a1
dïjnehkh	NX	sukker; farin	åa2,åa5
dïjpedh	V VI	ta; gripe; nappe (om fisk)	s4
dïrrege	N	verktøy; redskap	åa2
dïsse	X	til den	s3
döömedh	V VI	tømme	dej
döörhke	N	kragen; kragefettet (omkring tynntarmen)	dej
döörkenes	X	skjelving	s4
eadtjohke	N	ivrig; modig; energisk; entusiasme	s3,dej
eadtjohke lohkije	X	ivrig leser	s4
eajtohte	X	i gal retning; “ut på viddene”	s4
ealehke	X	vondt; trasig	åa5
earoeladtje	X	ærlig	s3
eatneme	N	jorden	s4,a1
ebrie	N	regn	s3,dej
edtjedh	V IV	skal; skulle	s1,s2,s3,a1,dej,åa5
eejehtimmie	N	ferie	s4
eejhtegh	NX	foreldre	s2
eejsedh	V VI	legge opp varme	s3
eensi	A	skikkelig; ordentlig	s2,s3,dej
eerkedh	V VI	erte; forarge	s2
eevre	Adv	aldeles	s3
eksamene	N	eksamen	a1
ektesne	Adv	sammen; ilag	s2,s3
ektine	Adv	sammen med	s3
elmie	N	himmel; luft; uvær; snøfokk med vind	dej,s3
enn	CC	enn	s2
ennje	Adv	ennå; (ikke) lenger nå; (ikke) på noen måte	s2,s3
faadta	N	kveike; nøreved	dej
faagkan	X	nesten	
faaledh	V IV	tilby	dej
faamoe	N	kraft; styrke	dej
faamoeh tjöönghkedh	X	samle krefter	s4
faatoes	A	som mangler	s2
faavroes	A	vakker	s4
fabrigkebarkije	N	fabrikkarbeider	a1
faehtie	N	reinmage; vomma; magesekk	s3,s4,dej
faelhkiebaernie	X	forlovet gutt eller mann	s2
faerhmiestidh	V	omfavne	dej
fahkedh	V III	våkne	a1,dej
fealadidh	V	reise; fare; drive på å farte	s2,s3
fealadimmie	NX	reise	s3
fealpere	N	stoppenål	s4
feeledh	V VI	reise; ferdes	dej
feeredh	V VI	fare; reise	dej
feete	N	tallerken	a1
fiejlie	N	feil	s4
fievsie	N	fjøs	s2
firrelidh	V	plutselig riste; skake	dej
foeresjidh	V	frakte; bringe	s2,s4,dej
fuehpemisnie	X	i travelheten	s2
fuehpesne	X	ha det travelt	s1,s2
fuehpie	N	travelt; travelhet	s3,s4
fuehpiedidh	V	ha det traveltskynde seg	s3
fuelhkie	N	familie	s1,s4
fååtesidh	V	mangle	åa5
fæjroe	N	fyrstikk	s1
fïereguhte	Indef	hver og en	dej
fïerhtene	Indef	hver; hvert	s2,åa5
fïerske	A	fersk	s3
fïjnedh	V IV	hefte seg; bli heftet	dej,s3
fïrredh	V VI	riste; skake; røre om	s4
föörhkedidh	V	le	dej
gaahkasjidh	V	stirre; nistirre	s4
gaahkoe	N	brød	s1,a1
gaahkoe-snaejrie	NX	brødskive	s3,a1
gaahpasjidh	V	måpe; stirre	s4
gaahtjedh	V IV	kappes; skynde seg	s4,dej
gaahtjeme	NX	konkurranse	s4
gaahtoe	N	katt	a1
gaaje	AdvX	særlig; veldig	s2,s3
gaajhke	Indef	alt	s2,s3,åa5
gaajhkesh	Coll	alle sammen (om mennesker)	s2,s3,dej,a1
gaajhkesh dovnesh	X	alle sammen (om mennesker)	s2
gaaktsede	A	åttende	s1,s2,a1
gaalloe	N	skallehuden av rein; panne	dej,s3
gaallohke	N	sko av skallehuden	dej
gaaloe-værsjoe	N	kjølig regnvær	s3
gaamege	N	sko	a1
gaamese	N	belling	dej
gaampe	N	kam	s3,a1
gaamsoe	N	klubb	s3
gaanedidh	V	omfavne	dej
gaaredh	V IV	knytte	dej
gaarhkedh	V IV	snøre; surre fast	dej
gaarkasidh	V	renne; gli av; rekke seg opp av seg selv	åa5
gaarkoehtidh	V	rekke opp (tarmene)	dej
gaarvanidh	V	komme bort; forsvinne; bli borte	dej
gaarvoe	N	klesplagg	åa5
gaasije	N	løype; kjese; kjesmage	s3,s4,dej
gaatodh	V II	bli borte; forsvinne; utebli	dej,s4
gaatske	N	nylig kastrert hannrein (om høstennår en har sett at den er riktig kastrert)	dej
gaavalohke	N	leietam rein; fører-rein	s4
gaave	N	krok; nøy; sving i elv eller bekk	a1
gaavelh-krievvie	NX	tamrein som lett følger menneskene	s4
gaavestidh	V	gjespe	a1
gaavnedh	V IV	finne (noe); finne frem (til et sted)	s3,dej
gaavnedidh	V	møtes	dej
gaavnjeres	AX	oval	s4
gabpeldidh	V	flyte	s4,åa5
gadtere	N	gang; alle leggskinn (bellinger); margbein; fotsener 	dej
gadtje-råtjka	NX	kjertel (mellom klovene på reinens bakfot)	dej
gadtsese	N	den delen av bellingen som er nærmest kloven	dej
gaedtie	N	sjøstrand	åa5
gaedtie-bealesne	X	ved strandkanten	s1
gaegniedidh	V	klare; greie	s4
gaejpie	N	hake; den fremre delen av underkjevestykket på slaktet rein (danner et stykke for seg)	dej,s3
gaejvie	N	rein som streifer egenrådig omkring	s4
gaekere	N	reinlort (om vinteren)	a1
gaektsie	Num	åtte	s1
gaeledh	V I	vadde; vade	dej
gaertene	N	gård	s2
gaerviehtidh	V	miste; somle bort i	s3
gaervies	A	ferdig (til bruk) (om matklærved osv)	dej,åa5
gaetskedh	V I	bite; kastrere ved å bite over testiklene med tennene	dej
gaetskehke	N	reinokse under første året etter kastrering (dersom den mister hornene)	dej
gahpedh	V IV	reise seg på to for å slå (om kjørerein)	dej
gahtjedh	V IV	falle; ramle ned 	s3,dej,åa5
gahtjehtidh	V	avlive; flå; la falle	s3,åa5
gahtjehtidh	V	flå; flekke	dej
gajhkedh	V IV	tørke; tørkes	dej
gajhkehtestedh	V I	tørke litt	dej
gajhkesjidh	V	tørke (skinnpaltblod m.m)	dej
gajhkestehtedh	V	tørke	s3
gajpe	N	hatt	a1
galhkedh	V III	slutte; bli ferdig med noe	dej,s3,åa5
galkas-aske	N	oktober	dej
galkedh	V IV	måtte; skulle; flyte; renne	dej
gallanidh	V	bli mett; mettes	dej,s3,s4,åa5
gallasodtje	A	mett	åa5
gallesh	Pron Coll	mange	s3
galme-guelieh	NX	frossen fisk	s3
galmes	A	kald	dej
galmetjaetsie	NX	kaldt vann	s4,a1
gamhtse	N	skinnhanske	dej,s3,s4,a1
gamte	A	bred	a1
gaptjedh	V IV	legge over; breie over; lukke dør	dej
gaptjeldihkie	AX	er overdekt	s3
gaptjese	N	dekke; noe man dekker med	a1
garmerdidh	V	skryte	dej
garmere	AX	stolt	dej
garrelaejpie	N	hardbrød; knekkebrød	a1
garres	A	hard; hardt	dej
garretjaetsie	NX	brennevin	s4
gaskebiejjie	N	middag; midt på dagen	s2,s3
gaskedh	V IV	lyne; slå (ild)	dej
gaskejïjje	NX	midt på natten	s2
gaskevåhkoe	N	onsdag	a1
gaskoeh	Po midt på; i midten	åa5
gaskoeh	Pr midt på; i midten	åa5
gaskoeh	Adv midt på; i midten	åa5
gavtjedh	V IV	falle på ryggen	åa5
geahpoe	N	lunge	dej,s3
geajnoe	N	vei	s2,dej
geajnoe-raejkien	AdvX	etter vegen	dej
gearkeske	A	steinete	dej
gebrie	N	hardt føre som bærer	dej
geegke	N	kagge	dej
geehpehtidh	V	åpne (døren) på vidt gap	dej
geehpes	A	lett	dej
geehtedh	V VI	passe; passe på	dej,åa5
geeles	A	leietam; som kommer etter (om rein)	dej
geelkedh V VI	rekke fram; tilby	dej
geelle	N	ektemann; mann; husbond	s1,s2,a1
geellege	N	(min) kone; hustru	a1
geerjedh	V VI	glede	dej
geerjene	A	glad; lykkelig	s4
geerve	A	vanskelig; dårlig (om vær)	s2
geervedovvedh	V IV	bli voksen	s2
geesjelihks	AX	ordentlig; skikkelig	s2
geevledh	V VI	skjære ut fram- og bakbellinger av en slaktet rein	dej
gejhkie	A	tørr	s3
gejhkie-bearkoeh	NX	tørket kjøtt	s3
gellie	Num	mange	s3,dej,s2,a1
gellie	Indef	mange	s3,dej,s2,a1
gelmedh	V I	fryse; fryse til	s2,s3,s4,dej
gertjie	N	foss i bekk;stryk	s1
gidtjh	Adv	nemlig; sikkert	s3
gie	Interr	hvem	s1,s2,s3,dej,a1
gie dellie datne	X	hvem er så du	s1
gie joem	X	noen	s3
giebnie	N	kjele,kopperkjele	s1,dej
giedtie	N	reingjerde	s2,dej
giedties	AX	smal	s4
gieh	X	hvem (hvilke personer)	s2
gieltegs	AX	spennende	s2,s4
gieries	A	kjære	s3,s4
gierkie	N	stein	s4,dej,åa5
giertiesijjie	NX	flyplass	a1
giesedh	V I	dra; trekke	dej,åa5
giesege	Adv	om sommeren	s3,åa5
gieseme-moere	NX	"bråkjern" som er laget av tre ( for å trekke skinn gjennom)	dej
gieseme-ruevtie	NX	skavjern"bråkjern" (som en trekker skinn gjennom)	dej
giesie	N	sommer	s4,dej,åa5
giesie-laante	N	sommerland	åa5
giesiebarkoe	NX	sommerjobb	dej
giestie	X	fra hvem	s3
gietjie	N	ende (av remtau mm)	s1
gietskiebasse	X	nærmere	åa5
gievlie	N	ring om kjorehullet	s4
gihtjedh	V VI	spørre	s2,s3,a1,åa5
gihtjedidh	V	spørre (flere); forhøre seg	a1
gijhtedh	V I	takke	s1,dej
gille	Indef	noen få	s1,dej
gilmehtahke	N	fryseboks; fryser	s4
girmedh	V VI	rose; skryte	åa5
girtedh	V I	sveve; kretse	dej
girtie	N	fly	s1,s4
girvene	AX	villig	dej
goebpere	N	sopp	s4
goejesjidh	V	barke; ta av bark	s4
goekedh	V IV	skinne (om solenmånen)	dej,s4
goelke	N	et hår	dej
goelke-gaamege	NX	skinnsko	s3
goeredh	V IV	følge spor; bevege seg langs noe; følge langsmed noe	dej
goerehtidh	V	spørre; etterforske; undersøke	dej,s3
goerne	N	kvern	s4
goerpe	N	uheldig; det var skitt	s4
goerve	N	pølse	s1,a1
goese	N	gran	dej
goetsedh	V IV	springe på fire føtter; klatre	dej
goetsehtidh	V	springe etter; jage på	dej
goeve	N	desember; frostrøyk	s2,a1,dej
goevledh	V IV	kikkese etter	dej
goevte	N	februar; midtvinter	s2,a1,dej
goevtes-moere	NX	langsgående spile til spiling av skinn ( også skalleskinn)	dej
gogkoe	Adv	hvor; hvilken vei; på hvilken del	s3
goh	CS	da; liksom; som om; enn; den gang da	s1,s2,s3,åa5
gojhkelovvedh	V	være tørst; tørste	s4
golke	N	oktober	s2,a1,dej
golkedahke	N	slutten av brunsttiden	dej
golkedh	N	slutten av brunsttiden	dej
golkehke	N	utmattet rein etter brunst	dej
golme	Num	tre	s1,s2,dej
golmeluhkie	num	tretti	s2
goltelidh	V	lytte; høre på; lystre	dej
gon	CC	og (forkortelse av gonnoeh)	s2,a1
gonnoeh	CC	og (om to som hører sammen)	s1,åa5,a1
gorredidh	V	ta vare på; berge; redde	dej
gosk	PcleX	til; inntil (om tid)	s4
gosse	Adv	når; da (om tid); til hvor	s2,s3,åa5
gossehts	NX	hoste	s2
govhte	Num	seks	s1
govhtede	A	sjette	s1,s2
govjehke	A	overmåte snar; hurtigløper	dej
govledh	V IV	høre	s1,s2,s3,a1,dej,åa5
govledh X	V	høres	dej
govlijidh	V	få høre; plutselig få høre	dej
gualijes	A	fiskerik (om sjø)	dej,s3
guapa	N	sokk; strømpe	a1,dej,a1
guarjasjidh	V	ligge (om dyr)	s4
guarkedh	V III	forstå; skjønne; begripe	dej,s1,s2,s3,a1
gubpede	Adv	hvorfra; fra hvilken kant	dej,s1,s3,a1
gubpene	Adv	hvor hen	s3
gudtsene	X	vel bekomme	åa5
gudtsien	Interj	takk (for mat og drikke)	s1,dej,a1
gudtsien prïhtjegen åvteste	X	takk for kaffen	s1
gudtsiestidh	V	takke (særlig for mat og drikke)	a1
guedtedh	V I	bære; kalve	s1,s3,s4,dej,åa5
guehpere	N	negl; klov	dej
guehperen-lïetse	NX	lyden av reinens klover	dej
guejmie	N	kamerat; følgesvenn	s3
guektien-giertien	X	dobbelt	åa5
guelehts	AX	uten fisk; fiskeløs	s4
guelhtie	N	kaldt vær om sommeren	s3
guelie	N	fisk	s2,s3,dej,åa5
guelie-bïjle	NX	fiskebil	s3
guelie-gaahkoeh	NX	fiskekaker	s3
gueliebarkije	N	fiskarbeider	a1
gueliebarkoe-sijjie	NX	fiskemottak	s4
guelmiedahke	N	speil	s3
guelpie	N	gulv	a1,åa5,a1
guessie	N	gjest; fremmed	dej,s1,s2,s3
guevtele	N	skogløs fjellvidde; snaufjell	s2,s4
guhkiem	Adv	lenge	s2,dej
guhkies	A	lang; langt	dej,s3
guhkies-buejtie	N	den innerste del av tykktarmen (nærmest småtarmene)	dej
guhth	X	hvem; hvilken (flere)	s3
guhtsedh	V I	våke; være våken	s1,s2
gujht	Pcle	nok; jo allikevel; da; nå	s1,s2,s3,åa5,a1
gujmie	Po	med	s2
gujredh	V VI	pistre	dej
guktie	Adv	hva (i spørsmål om navn); hvordan; hvorledes	s1,s2,s3,åa5,a1
guktie gåarede?	X	Hvordan går det?	s2
gullievæhta	NX	gullmedalje	s4
gullieværjoe	NX	gullsmykke	s4
gurkedh	V VI	helle	dej,åa5
gurkestidh	V	helle; helle som snarest	a1,åa5,a1
gurremeabpese	N	strikket genser	a1
gusnie	Adv	hvor	s1,s2,s3,åa5,a1
gussene	X	i velbehag; velbekomme	s3
gustie	Adv	hvor fra	s3
guvvie	N	bilde; kort	s2,s3
gyhtjelasse	N	spørsmål	a1
gyhtsele	N	snegl	dej
gyrhkesjidh	V	gå i kirken	s4
gyrhkesjimmie	NX	gudstjeneste	s3
gyvjehke	A	overmåte snar; en som løper fort; som har god kondisjon; hurtigløper	dej
gyöhpehke	A	lett	dej
gyölledh	V IV	klare å følge med; henge på	s4
gyölleme	N	levret blod	s3
gyönegs	AX	dugelig; brukbar; passende	s4
gyösedh	V V	bli dratt; slepe etter	dej,s4
gåabpatjahkh	Indef	begge to	dej
gåabph	Adv	hvor; hvor hen	s1,s2,s3,dej,åa5
gåabregidh	V	rulle seg sammen (om never)	s4
gåajkoe	Po	til; hen til; henimot	s2,s3,dej,åa5
gåajkoe	Pr	til; hen til; henimot	s2,s3,dej,åa5
gåajvodh	V II	øse opp	dej,åa5
gåajvoestidh	V	øse opp (litt)	s3
gåalmede	A	tredje	s1,s2
gåalodh	V II	fryse	dej
gåaltoe	N	snøføyk	s2
gåaltoe-hovme	NX	snøkov	s3
gåamalohke	N	blindtarm hos rein og andre drøvtyggere	s4,dej
gåangkoeh	A	kroket; bøyd	s4
gåaradidh	V	gå an; være mulig; være høvelig	s2,s3,åa5
gåarodh	V II	sy	s3,s4,dej
gåaroes	A	tom	s4,dej
gåassodh	V II	være gjest; få bevertning	s3,dej,åa5
gåassoehtæjja	N	vert	s3
gåatodh	V II	beite; finne gress	s3,dej
gåatome	N	beite	s2,s4
gåeblie	N	snøskavl	s2,s3
gåeskie	N	ens mors eldre søster; ens mors eldre kusine; ens mormors eldre søster	a1
gåeskuve	N	en kvinnes yngre søsters sønn; en kvinnes yngre søsters datter	a1
gåessie	Adv	når; når da	s1,s2,s3,dej,åa5,a1
gåetehke	N	samboer	a1
gåetie	N	hus; gamme	dej,s1,s2,åa5,a1
gåetie-ietnie	NX	vertinne	s3
gåetie-neastetjh	NX	matrein	s3
gåetie-sjalja	NX	gårdsplass	dej
gåetiebarkoe	NX	husarbeid	s4
gåetieluhpie	N	husrom; husvære; hybel	s3,s4
gåeties-sijjie	NX	gammeplass; husplass	åa5
gåhkasjidh	V	synes at noen blir lenge borte; vente lenge på	s3
gåhkese	Adv	langt	dej
gåhtjodh	V II	kalle; benevne; kalle på	dej
gålkoe	NX	november	dej
gåmma	N	gift kone; frue; kone	s1,s2
gåmmebe	NX	vedkommendes kone; vedkommendes hustru	s2
gåptoe	N	kofte; kjole	a1
gårkasidh	V	renne	dej,åa5
gårredidh	V	knyte	åa5
gårroebielie	NX	venstre side	s2
gårroeh	A	venstre	åa5
gåvle	N	løkke av lær (på sko til feste for skoband; på sekk og komse til feste for trekkbånd.)	dej
gåvnahtalledh	V IV	si farvel (til flere)	dej
gåvva	A	greit; lett; bra (helst i nektelse)	åa5
gåårestahke	NX	sytråd; senetråd for å sy med	dej
gåårkasidh	V	renne 	s3
gåårvedidh	V	kle seg; ta på (klær)	s1,dej,a1
gæbjan	AX	syk; sykelig	s2
gæjhtoe	Inter	takk	s2,s4,dej,åa5
gæjhtoe	N	takk	s2,s4,dej,åa5
gæljodh	V II	rope; skrike	dej
gællasjidh	V	ligge	dej
gænnah	Pcle	ikke (forsterkende); heller ikke	s2,s3,åa5
gærhkoe	N	kirke	s2,s3
gærja	N	bok	s1,dej
gærjabusse	NX	bokbuss	s4
gærjagåetie	NX	bibliotek	s4
gæstoe	N	kiste	s2
gævnjasjidh	V	henge (om flere ting)	dej
gævnjodh	V II	henge opp (flere ting)	dej,s4
gævnjoestidh	V	henge opp (litt), henge opp (om en ting)	s3,dej
gïebredh	V IV	surre rundt noe	dej
gïebrelgovvedh	V	vikle seg inn	åa5
gïehtelidh	V	holde på med noe; være aktivisert; streve	s1,s3,s4,dej,åa5
gïehtjedidh	V	se; se over; se grundig etter; betrakte	s2,s3
gïele	N	språk; stemme	s1,s2,a1
gïelehtadtje	AX	målløs; stum; en som er stum	s4
gïelekuvsje	NX	språkkurs	s1
gïeltege	N	den dypere bøyesenen på reinens bakfot	dej
gïemhpes	A	snill; tjenestevillingflink	s4
gïen	X	hvem sin	s1,s3
gïengele	AX	dyp (elvsjø)	s4
gïerh-gietjie	NX	toppende	dej
gïerte	N	siderom i reingjerde for skilling	dej
gïese	X	til hvem	s3
gïesedh	V IV	surre på seg skoband	dej
gïete	N	hånd; arm	s2,s3,åa5
gïete-værjoe	NX	håndleddssmykke	s3
gïetedalledh	V	behandle	s4
gïhpe	N	fløte	s1,åa5
gïhpelaejpie	NX	bløtkake; kremkake	s2
gïjre	N	vår	s4,dej,a1
gïjredaelvie	N	vårvinter	s4
gïjrege	Adv	om våren	dej
gïjregiesie	NX	vårsommer	s4
gïknjele	N	tåre	s4
gïknjelsovvedh	V	bli fylt med tårer	s4
gïlmetahke	NX	fryseboks	s3
gïpte	N	pinne til å træ fiskegarn på; garnstikke	åa5
gïrre	N	bark (av nåletre/innerbark av løvtre); skall;skorpe	s1
gïrse	N	luftrør	dej
göökte	Num	to	s1,s2
göökteluhkie	Num	tjue	s2
göökten harran	X i to deler	s4
gööktesh	Coll	to sammen	s1
gööledh	V VI	fiske	s2,s3,dej,a1
gööleme	N	fisking	s4
göölestidh	V	fiske (litt)	s3
göölije	N	fisker	a1
gööthsijjie	N	kåteplass	s4
haabpe	N	øverste margbein på reinens framfot	dej
haajpanidh	V	forsvinne; kommer bort	s4
haampeldidh	V	hamle; ro bakover	
haarhtje	NX	huskeråd	åa5
haaskoe	N	rusk; smuss	åa5
haavjoelidh	V	plutselig forsvinne; komme bort	s3
haelieh	NX	pinner som brukes for å spile ut skinn på bakken	dej
haelsie	N	sølvkrage	s4
haermie	N	øyenbryn	s3
hahtjoe	N	hytte	åa5
hajkedh	V IV	springe; løpe (om dyr); kaste	s4,a1,dej
hajkedidh	V	holde på å springe; springe hit og dit	a1
hajkodh	V II	kaste (flere gangerflere ting)	dej
hartsoeh	AX	slurvete; uvøren	åa5
hearra	N	prest	a1
hearskoes	A	velsmakende (om fisk); lekker	s3
heelsedh	V VI	hilse	s3
heelsege	N	hilsning	s3
heevtedh	V VI	kaste; slenge	dej
hepsedh	V I	lukte; kjenne lukt av noe	s4
herrehke	N	pinne; stikke	åa5
hierkie	N	hest	s2,s3
hievnieviermie	NX	spindelvev	s4
hijven	A	bra; godt	s1,s2,s3,dej,a1
hijven hov	X	det er bra	åa5
hojjedh	V IV	klage; jamre	dej
hoksehtæjja	NX	servitør	s1
hopsedh	V V	lukte; gi fra seg lukt	dej
hosbåanta	N	husbonde	s2
hov	Pcle	jo; da	s2,s3,åa5
huhtedh	V I	søke; gjø; bjeffe om hund	s4,dej
hurrie	N	orrhane	dej
håagkh-staavra	NX	fiskestang	s3
håalodh	V II	snakke; holde tale	s4
håhkoe	N	håp	dej
håjradidh	V	rekke; hyre	dej
håågke	NX	fiskekrok	s4
håålesjidh	V	spile ut skinn på bakken til tørk	dej
håålesjimmie	AX	utspilt	dej
hæhtjoe	N	hytte; skur	s3,s4
hævvi	Pcle	selvfølgelig	s2
hïegke	N	liv	s3
hïeje	N	bryllup; bryllupsfest	s3,s4
hïejeguvvie	N	bryllupsbilde	s2
hïerpedh	V IV	skvette til; bli redd	dej
hïnnedh	V IV	rekke; nå	dej
hööptedh	V VI	hefte; forhindre	s4
iehkede	N	kveld	s1,s3,dej,a1
iehkeds-biejjie	N	ettermiddag	dej
ierie	N	ærend	dej
ietniengïele	N	morsmål	s2
ij åejjieh vielie guedtieh	X	hodet mitt kan ikke ta imot mer	s4
ijje	Interj	nei	s2,åa5,a1
iktegisth	Adv	bestandig	s2,s3
iktesth	Adv	bestandig	s4
illedh	V VI	gjøre ferdig; klargjøre	s2,s4
inhtsie	AdvX	spesielt; utelukkende; slett (ikke)	s3
jaa	Interj ja	s1,a1
jaa nov maa	X	ja selvfølgelig	åa5
jaavvoeh	NX	mel	s1
jadtehtidh	V	sette; dra ut garn	s3,dej,åa5
jaehkedh	V I	tro; tro på; lite på	dej
jaemedh	V I	dø	dej
jaepie	N	år	s2,a1
jaepieboelhke	N	årstid	s4
jaevrie	N	sjø; innsjø; vann; vatn	s1,s2,s3,åa5
jaksedh	V IV	nå; innhente; rekke fram; makte; kunne	s3,s4,a1,dej,åa5
jakseme mieresne	X	innen rekkevidde	s2
jaksoes	X	innen rekkevidde; tilgjengelig	s4
jalke	A	slett; flat mark	s4
jallan	Adv	knapt; så vidt	åa5
jallese	Adv	vestover	dej
jallh	CC	eller	s2,s3,a1
jalloe	N	høyde	s4
jarhpoeh	A	vilter; skøyeraktig	s2
jarkedh	V III	snu; vende om	dej
jarkoestidh	V	oversette	a1
jarnge	N	midt; midtpunkt	dej
jassijes	A	tykk	s3
jeananidh	V	bli mere; utvide seg	s4
jeatja	Indef	noe annet; annerledes	s3,åa5,a1
jeatjah	X	annen; annet; andre	s2
jeatjebh	X	(de) andre	s3
jeenemes	X	mest; flest	s3
jerkiehtidh	V	snu plutselig; vende om plutselig	s2
jiehtedh	V I	si	s1,s2,dej,åa5
jiekie	N	fars eldre bror	s2,a1
jiekuve	N	en manns yngre brors sønn; en manns yngre brors datter	a1
jieledh	V I	leve	s2,s3,dej
jieleme	NX	liv	s4
jieleme-guvvie	NX	film	s1
jienebh	X	mere; flere	s3,s2
jiesie	NX	rundt hårlag på reinens bakfot på innersiden av hasen	dej
jievege	N	teppe; pledd	s3
jijhtedh	V I	komme fram; vise seg; komme til syne; gå opp( om solen)	dej
jilletje	X	vestkant	åa5
jimhkelidh	V	utslette; la det bli mørkt	s4
jirreden	Adv	i morgen	s1,a1,dej
jis	Pcle	nå; i sin tur	s2,a1
jissehts	A	tynn	s4
joe	Pcle	allerede; allerede nå	s1,s2,s3,dej,åa5
joejkedh	V IV	jojke	s1,dej
joekoen	Adv	særlig; særdeles; særskilt	s1,s2,dej
joevenidh	V	spre seg	s4
johke	elv	dej
johketje	liten bekk	s2
johtehtjidh	V	drive på å flytte	åa5
joptse	N	suppe	dej
jorpe	A	rund	s3
jovjeråtnoe	NX	lysgrå reinsimle	s4
jovkedh	V IV	drikke	s1,s2,a1,dej
jovkemsh	NX	drikk	s1
jovnesåhkoeh	NX	midtsommer; Jonsok	s4
jovven	InterjX	jo; ja	åa5
juakasovvedh	V	bli delt	dej
juekedh	V I	dele; dele opp; avdele; dele ut	dej,a1
juelkie	N	fot	s3,dej
juelkie-bielieh	NX	hull i reinskinn etter framføttene	dej
jueskie	N	kaldt; kaldt vær	s3,s4
juhtedh	V I	flytte; bevege seg; gå	s1,s2,s3,a1,dej,åa5
juhteles	A	som går; løper lett; glir lett	s4
juktie	CS	slik at; fordi; da; når; for at; så at	s2,s3
jurjiehtamme-beapmoeh	NX	tillaget mat	s3
jurjiehtidh	V	stelle til; lage; tilberede (mat)	s3,s2,dej,åa5,a1
jurjiehtæjja	N	kokk; en som lager mat	a1
juskiedahke	N	kjøleskap	a1
juvre	N	dyr; rovdyr	dej
juvse	N	juice	a1
jyöne	N	morbror; mors bror eller fetter; onkel (på mors side)	s2,s3,a1
jåarhke-skuvle	videregående skole	s3,dej
jåaskoedehtedh	V	la avkjøles; la stå og bli avkjølt	dej
jåaskoestidh	V	bli litt avkjølt	s4
jåasoeh	tøysete; finner på tull	s2
jåhtajidh	V	flytte av sted; bryte opp; dra av sted; fare; dø; begynne å gli; gå av (om skudd)	dej,s2
jånga	bordkniv	dej
jårredh	V IV	snurre; rulle; gå rundt; danse; vende seg om	dej
jåvle	jul	dej
jåvle-aske	desember	dej
jååktan	i går	s2,a1
jååktetje-iehkeden	i går kveld	åa5
jæjsodh	V II	rime; bli rimet	dej
jïekedh	V I	være tett; holde vann ute (om sko)	dej
jïenge	is	s1,s4
jïh	og	s2,a1
jïjje	natt	s1,s2,dej,a1
jïjjedidh	V	overnatte	dej
jïjjegåårtese	her: oppholdssted for natten	s4
jïjjehtovvedh	V	overnatte	s4
jïjjen	om natten	s2
jïjnje	mye; mange	s2,s3,dej,åa5,a1
jïjnjesh	mange; mange sammen (om mennesker)	s2,s3
jïjnjh	mange	s1,s2,dej
jïjse	snøugle	dej
jïjtje	selv	s1,s2,s3,dej,åa5
jïjtjehke	selveste	åa5
jïlle	høg	dej
jïrreme	margbein; marg	s2,s3
jöödtedh	jøss bevares	s1
jöömmetjh	tvillinger	s4
jöörtedh	V VI	oppholde seg rolig innen et bestemt område	
kaarre	kar,mann,gutt	åa5
kilovmeter	kilometer	s2
klaahka	skistav	s4
klaapsa-spaarra	vanlig horisontal spile til skinn	dej
klaase	glass	a1
klaasetjelmieh	briller	s4
klaasse	klasse	s2
klaerie	farge	s2,a1
klaeries	klar (om vær)	a1,dej
klajkesidh	V	gale gjentatte ganger; drive på å gale (om gjøk); mase (om barn)	dej
klajkoehtidh	V	gale (om gjøk)	s4
klovperdidh	V	blendes (smerte) i øynene om våren med sol på snøen	s4
klovse	helt hvit rein (albino)	dej
klååmsehth	vær med ustadig vind slik at røyken slår inn	s3
knugkedh	V VI	gni; gnugge; massere	dej
konsulente	konsulent	a1
kontejnere	konteiner	dej
kontovre	kontor	s2
kontovrebarkije	kontorarbeider	a1
kontovrebarkoe	kontorarbeid	s4
kraanna	nabo; granne	dej,s2
kreemsedh	V VI	gripe; ta fatt i	dej
krievvie	reingjord	dej,s3
krist’-aehtjie	gudfar	s3,s4
krist’-ietnie	gudmor	s3
kritnedh	V IV	murre; knurre (om hund)	dej
kroehkedh	V IV	grave; rote	dej,s3
kruana	grønn	s2,a1
kruepies	grov	s4
kråahpe	kropp	s4
kråavvegidh	V	krumme seg; bli kroket	s4
kråvna	krone	s1,s2,s4
kråånedidh	V	begynne å grønnes	s4
kröövvehtalledh	V IV	drive på å gjøre noe kroket (flere ting)	dej
kuvsje	kurs	s2
kveita	kveite	s3
kåahpe	kopp	s2,s3,åa5,a1
kåalhta	stekepanne	s4
kåarhte	kort	a1
kåava	forstue; bislag; gang; uthus	s4
laadtege	multe	s3,åa5
laadth-pluevie	moltemyr	s3
laahkoe	slektskaptittel; svogerskapstittel	a1
laaje	laug	dej
laakan	på (den og den) måte	s3
laante		a1
laatege	skispor	s4
laavkodh	V II	døpe (bade)	s3,a1
laavkome	dåp	s3
laavkometjïehtjele	baderom	a1
laavlodh	V II	synge	s4
laavvadahke	lørdag	a1
laehpedh	V I	forlate; la bli igjen; legge igjen	dej,åa5
laejhtedh	V I	kritisere	s4
laejkie	tråd	s4
laejpie	rundt brød,brød; flatbrød	dej,s1,a1
laevie	slektning; søskenbarn; tremenning; firemenning	s4
lapte	loft	a1
latjkedh	V III	bli enige; komme overens; bli isfri; gå opp (langs landom sjø)	dej,s4
lea	er	s1,s2,a1
leahpa	billett	s1
leavloe	tyngde	s4
ledtjie	tro om (uttrykker tvil)	s3
leejjedh	V VI	leieta i leie	s3,dej
leekedh	V VI	slakte	dej
leekedidh	V	slakte flere dyr	s2,a1
leekedæjja	slakter	s4,a1
leekeme-bovtse	slakterein	dej
leekeme-bïjle	slaktebil	dej
leeredh	V VI	lære; lære ut; undervise	a1,s2
leerehtidh	V	lære (noen andre)	s1
leesedh	V VI	låse	dej
leessedh	V VI	lesse på	s4
librie	lever	s2,s4,dej
lidtedh	V VI	jakte etter fugl	dej
liebnedh	V I	helle i; fylle	s4
liehties	billig	s2,s4
lihtie	kjørel; kopper og kar; kar; dekketøy; bøtte; trau	a1,dej,åa5
lihtievåarhkoe	koppskap	s2
lijhkiemåvhka	kortbukse; truse	a1
lijhkiesjåarhtoe	t-skjorte	a1
lijnie	skal; tørkle; duk	s2,dej,a1
lijrehtidh	V	leie noe i band (hundreinhest osv.)	s2
lissie	tillegg	s2
lissiehtidh	V	forøke; helle på mer; få fatt i mer	dej
lissine	i tillegg	s1,s2
loehke	lukket pulk (med lokk og lås)	dej
loejhmedh	V IV	klage; jamre	dej
loekte	vik; bukt	dej,åa5
loese	laks	s3
loevenidh	V	løsne; komme seg avgårde	s3,dej
loeves	løs	dej
lohkedh	V IV	lese	s2,a1,dej
lohkehtidh	V	undervise	a1
lohkehtæjja	lærer	s1,s2,s3,a1
lopme	snø	a1,dej
lovvedh	V IV	bli våt	dej
lovves	bløt; våt	s3,dej
luajhtadidh	V	gå ned (om sola)	dej
luehkie	lokk	s3
luejhtedh	V I	slippe løs; slippe; slippe ut; gi slipp på; la gå; miste; gi avkall på noe	s4,dej
luemtedh	V I	legge seg og ikke ville gå (om rein)	dej
luepkedh	V I	dele (på langs); kløyve; flekke	s3
luhkie	ti	s1,s2
luhkiegåalmede	trettende	s2,a1
luhkiemubpie	tolvte	s1,s2
luhkievoestes	ellevte	s1,s2
luhpiedidh	V	love; avgi et løfte	s4
luste	moro; morsomt; fornøyelse; hygge	s2,dej,åa5
lusten gaavhtan	for moro skyld	s2
lustes boelhketjh	morsomme småstykker	s4
lustestalledh	V	more seg	s3
lutnjedh	V VI	løfte	dej,åa5
luvhtedh	V VI	måtte	dej
luvnie	hos	s2,dej,åa5
lyjhkedh	V V	like; være glad i	s3,dej
lyövlehke	tung	dej,åa5
låadtodh	V II	klyve (flere ting)	s3
låajtoe	gammegulvet	s4
låavth-gåetie	teltkåte	s3,s1,s2
låedtjie	vinnstille; stilt	åa5
låesuvh	bjørkekvister lagt samme veg for å legge noe oppå	dej
låevtedh	V I	anfalle; angripe; gå på	dej
låhkede	tiende	s1,s2
låhkoe	leksjon	s1,s2
låpsoedahke	fuktighet	s4
låvledh-vearelde	østavær	s3
læjhkan	likevel	s2,s3
læstoe	liste	a1
lïegkedidh	V	hvile	s2
lïegkestidh	V	hvile; hvile litt; ta det med ro; ta en liten rast	s4,a1
lïeme	sodd; kraft av kokt kjøtt eller fisk	s4
lïemkede	mildt	s4
lïene	temperert; lytt	dej
lïepse	isterdekket rundt vomma; fettlaget rundt vomma	s4,dej
lïeredh	V IV	lære seg	s2,åa5
lïerhkelidh	V	drive reinflokken ned fra fjellet til et bestemt sted	dej
lïgkedh	V IV	fyke igjen; tilsnøes; overfykes	s3
lïhtse	ledd; hvirvel	s3,dej
lïhtsege	ryggrad	a1,dej
lïhtsestidh	V	skjære opp ledd	dej
lïjhtere	liter	s1
lööbpedh	V VI	breie utover	dej
löönedh	V VI	låne	s3,s4,dej
löövedh	V VI	ta løs; skille	s3,åa5
lööveldidh	V	løsgjøre; ta løs	s3
löövje	te; saft fra trær (einerlåg)	s1,s2,s3,åa5,a1
löövles	tung	s3
maa	jo visst; sannelig	s2
maadth-gietjie	rotende	dej
maadthskuvle	grunnskole	s2
maahtoe	kompetanse; kunnskap	s4
maaje	riktignok; enda; selv om; skjønt; endelig; heldigvis	s3
maajke	varmt vær uten sol	s3
maaksoe	betaling	s3
maalese	måltid	s3
maam	hva	s1,s2,s3
maam joem	ett eller annet	s2
maam-akt	et eller annet	dej
maana	barn	s1,s2,dej,åa5,a1
maana-baelie	barndom	dej
maanageehtije	barnepasserbarnevakt	s4,a1
maanagïerte	barnehage	s2
maarhke	mark	s3
maaskenidh	V	vikle seg sammen; floke seg (om garn)	åa5
madtan	dårlig; syk	s2
madtan laakan	knapt nok	s1
madtjeldehtedh	V	gjøre glad; fornøyd; oppmuntre	s4
madtjeles	glad; fornøyd	s4
maedeles	heldig	s3
maehtedh	V I	kunne; greie; ha ferdigheter til	s1,s2,s3,a1,dej
maehtehtje	flink; dyktig	s4
maejstedhI	smake	a1
maeksedh	V I	betale	s1,s3,dej
maelie	blod; blod fra dyr	s3,dej
maelie-gaamsoe	blodklubb	s3
maeliegoerve	blodpølse	s4
magkere	hva slags	dej
magkeres	hva slags; hva for	s2,s3
magkerh	hva slags; hva for	s2
mah	mon; om (innleder spørresetninger)	s1
mahte	nesten	s1,åa5
man	hvorfor; hvor	a1
man båeries	hvor gammel	s2
man gaavhtan	i hvilken hensikt	s3
man gellie	hvor mange	s2,s3
man guhkiem	hvor lenge	s2
man jïjnje	hvor mye	s2
man jïjnjh	hvor mange; hvor mye	s2,s3
man stoerre	hvor stor	s1
man åvteste	hvorfor	s1,s2,s3,åa5,a1
mannasinie	hvorfor; til hva	s2,s3
manne	jeg	s1,s2,dej,åa5,a1
marngedh	V IV	vrenge; snu; vende tilbake	dej
maskastidh	V	rynke og sy fast overstykke (altese) på sko	dej
mastedh	V IV	blande seg; blande seg inn (om rein)	dej
meajvadovvedh	bli utslitt	s4
mearan	mens	s3
mearhkodh	V II	merke (reinkalver)	dej
mearoe	hav	s3
measehke	reinkalvskinn	dej
measetje	liten reinkalv	s2
meatan	med; sammen med	s1,s2,s3
mehkienjaevrie	Buktsjøen	s2
mejnie	med hva	s3
mejtie	mon; om (innleder spørresetninger)	s2
mennie mieresne	her; hva er	s1
mesnie	noe (å lese)	s4
mestie	hvorfra; hvorigjennom; hvorfor	s1,s2
miedtedh	V I	feile; synde; gjøre fortred; gjøre urett; gjøre noe galt	dej
mielhkie	melk	s1,s2,åa5,a1
miesehke	simle med kalv	s4
miesie	reinkalv	dej
mietene	rogn	s3
mietie	etter; langs; langs etter; henover; bortover	s2,s3,dej
mij	hva; hvilken; hvilket; noen; noe	s1,s2,s3,åa5,a1
mij dellie	hva da	s1
mij vielie	hva mere	s1
mij-akt	et eller annet	åa5
mijjieh	vi	dej
mijnuse	minus	s1
minngemes	til slutt; sist	s3,dej,åa5
minngie-staebnie	bakstavn (i båt)	
minngiegietjie	slutten	s4
minudte	minutt	s1
miste	ved et uhell; uten vilje	s4
moehrele	en kvinnes eldre søsters sønn; en kvinnes eldre søsters datter	a1
moehrele	mosters tantebarn	dej
moenedidh	V	gjette	s1,dej
moenjehth	klarvær (oppklarning)	s3
moere	ved; tre	s3,dej,åa5
mohte	men; mot; i motsetning til	s1,s2,s3
mojhteladtedh	V IV	forsøke å huske på mange ting	dej
mojhteleslaakan	med omtanke; forsiktig	dej
mojhtese	minne	s4
mojhtestehtedh	V I	minne en på noe	dej
mojjehtidh	V	smile	dej
monnen bïjre	om oss to	s2
motovre	motor	s2
mov	min; mitt	s2
muadta	pels; pesk;mudd	s1,s2,dej
muahra	en mors yngre søster; en mors yngre kusine; moster ( yngre søster til ens mor)	a1,dej,åa5
mubpie	andre; (den) andre; (den) annen	s3,s1,s2,åa5,a1
muerjie	bær; frukt	a1,dej
muerkiestidh	V	male (om katt)	s4
mujhtedh	V I	huske; minnes	s1,s2,s3,a1,dej
mullie	overskyet	s3
munnie	egg	s1
munnjien	til meg	s3
murhkedh	V VI	knuse	dej
murriedidh	V	trives; ha det hyggelig; hygge seg	s2,s3
mutskedh	V VI	bli stygt vær; være stygt vær	s3
mutskiehtidh	V	slå til med uvær	s3
myövhkes	mjuk; mjuke	dej,a1
myövhkes	myk	s4,a1
måanta	mandag	s1,a1
måara	knokkel; bein	dej
måarehks	sint	s1
måaroe	knokkel; bein	dej
måaskedh	V III	bli fornærmetbli sur	dej
måaskodh	V II	bli fornærmet; bli sur	dej
mådtan	syk	dej
måedtieh såarhth	mange slags; mange sorter	s4
måjhtajidh	V	komme på; huske på	s3,dej
målsodh	V II	skifte; bytte	s4,dej
mån	jeg (kortform av manne); vel; nok	s2,s1
månnoeh	vi to	s2
mårhkedh	V III	slås i stykker; gå i stykker	dej
måvhka	bukse	s4,a1
mænngan	etter; etterpå; senere; siden	s2,s3,dej,a1
mænngese	bakover	dej
mïelke	bryst	s3
mïerhkesjidh	V	merke; merke (flere kalver)	s3,s4,dej
mïetsedh	V I	knake	s4
mïetske	august; røyte; forråtnelse	s2,a1,dej
mïetskedh	V IV	råtne	s4
mïnnedh	V IV	gå; ta en tur; besøke;dra avsted	s2,s3,a1,dej,åa5
mïrhkekruana	mørkegrønn	s4
möörjedh	V VI	plukke	s3
naa	temmelig; nokså	s2
naa guhkiem	nokså lenge	dej
naajedh	V IV	snitte; skjære; skjære fint med kniv; risse	s4,dej
naakene	noen	s3,dej,åa5
naan	noe; noen	s1,s2,s3,åa5,a1
naan aejkien	noen ganger	dej
naavjodh	V II	ha sykdom; ha udyr i reinflokken; ha nød	dej
naehkie	fiskehode; del av fisk	s3
naemhtie	slik	åa5
naepie	navel	s3
nahkasjidh	V	klare; makte; orke	s4
nahkere	søvn; tretthet; drøm	a1
nahkeren	trøtt (utkjørt)	s3,a1
nahkestidh	V	sovne	a1
napkedh	V III	slites; bli slitt; utslitt (om klær og sko,skinn)	dej
nastedh	V IV	karre veden sammen i ilden; friske på ilden; legge på ilden	dej
neapede	en manns søsters sønn; en manns søsters datter	a1
neebnedh	V VI	nevne	s3
neeledh	V VI	skjemme; gjøre ukvass	dej
nehkiehtidh	V	puffe; skyve (frampåut); (holde på å) skyve på	s2,åa5
nejpie	kniv	s3,dej,åa5,a1
nejpien-sjapmere	knivbak	dej
nelnie	på; oppe; oppå	s2,dej
nierhkedh	V IV	begynne; ta fatt igjen	dej
nieskedh	V I	skrape av kjøtthinnen på skinn under beredning	dej
nieskeme-ruevtie	jern til å skrape skinn med	dej
nieskemegalte	langhel stokk til å skrape skinn på	dej
niestie	matrein	dej
niestie	slaktrein	s3
niestiesvoesse	nistesekk	dej
niestiesvoesse	nistesekk; matsekk	s2,s3
nietsege	leggbein	dej
nihtedh	V I	forby; true; få en til å tie stille	dej
nille	opp på	s3
nimhtie	slik; på den måten	s1,s2,s3
njaame-lijnie	håndkle	s3
njaamedh	V IV	tørke noe	dej
njaarege	halskjøtt	dej
njaarpodh	V II	bli tynnere	dej
njaavhkodh	V II	mjaue	dej
njabpestidh	V	gli av	åa5
njaelkie	god	dej,s3,åa5,a1
njaelkieslaakan	god; godt på en behagelig måte	dej
njaelmie	munn	s3
njalkedh	V III	bli hårløs (om skinn som er lagt til avhåring)	dej
njalleme-juelkie	flådd fot	dej
njalles-buejtie	ryggspekk; ryggfett	dej
njamma	bryst for diing	s3
njeajkedh	V III	sige ned; gli av (om snøjordmassertorv osv)	s4
njealjede	fjerde	s1
njealjehts	kvart	s1
njeeruve	tørr; gressbevokst voll	s4
njeervedh	V VI	male; knuse i stykker	s4
njelledh	V I	flå skinn; flekke av never; løype never	dej
njelliestidh	V	flå; flekke litt	dej
njeltedh	V I	avhåre (skinn)	dej
njielje	fire	s1
njieljede	fjerde	s2
njilkehtidh	V	avhåre	dej
njilledh	V IV	flekke; flå; rive av	s3,s4
njoektjeme	tunge	s2,s3,dej
njoetjeles	mykt; glatt	s4
njoetsedh	V VI	modnes	s3
njoevegh	innmat; innvoller av fisk når de er tatt ut	s3
njoktje	mars; svane	s2,dej,a1
njolledh	V V	slippe lett (om never)	s4
njorkedidh	V	plystre	s4
njuana	tange; nes	dej
njuenehke	de fremste reinene i flokken	dej
njuenie	nese	s3
njulhtjedh	V VI	hoppe	dej
njulhtjestidh	hoppe til	åa5
njuvvie	strøm (i elv,bekk)	dej
njåalodh	V II	slikke	dej
njåemele	kanin	s1
njååjte	unnabakke	s4
njæjhkodh	V II	gråte (om barn og voksne); pistre (om hund)	dej
noeledh	V IV	knyte opp; løse opp; kle av	s3,dej
noelestidh	V	kle av som snarest; løse opp	s3
noere	ung	s2,s4
noerhtelen	nordafor; nord om	s2
noerhteraedtesne	på nordenden	s4
noerhtese	nordover	s3
nomme	navn	s1,s2,s3,a1
nossedh	V IV	pusle; fordrive tiden	dej
novh	ja; jo visst; nok	s1,s2,åa5
novh amma	jo; jo visst; altså; virkelig; sikkert; sannelig	s1
novh hævvi	selvfølgelig	s2
novh lea	jaslik er det	s3
novh maa	jo da; ja riktignok	s3
nuarvan	støvet; full av boss	s4
nuehtie	not	s4
nuekies	nok	s3
nuelesne	under	s3,dej,a1
nuelie		a1
nuepie	sjanse; anledning	s3
nuhtjedh	V VI	nytte; bruke; benytte	a1,dej
nulle	null	s1
numhtie	slik	åa5
nyjsene	kvinne	dej
nyjsenæjja	kvinne	s2,dej
nyöjhkedh	V V	nekte; avslå; ikke gi lov	s4,dej
nåajtodh	V II	spå; trolle	dej
nåake	dårlig	dej
nåaledh	V IV	snakke; prate	dej
nåalodh	V II	ymte; snakke frampå	dej
nåejtie	trollmann; sjaman	dej
nåekies	dårlig; dårlig (om klærværbeitehelsetilstand osv.)	s2,a1
nåhtedh	V	nytte; bruke	s4
nåljode	uten horn	s4
nårtodh	V II	gå med på	dej
nåts	enn	s1
nåå	nå	s1
nåå buerie veasome hov	vi lever bra	s2
nåålesidh	V	løsne	dej
nåånåå dellie	adjø så lenge; på gjensyn	s1
nååts	enn	s2,åa5
nænnoes	sterk; solid; holdbar	s2,dej
nïejte	jente; datter; ugift datter; kjæreste	s1,s2,dej,a1
nïere	nød	s3,s4
nïhpesjidh	V	kastrere; gjelde	dej
nïlle	oppå	dej
nïmmerh	tynntarmene og tarmfettet til sammen	dej
nöökedh	V VI	være fornøyd	dej
nööredh	V VI	ha tid; anledning (til å gjøre noe)	s1
nöörjen		a1
ohtje-gåetie	WC; do; toalett	s1,s3
ohtsedh	V IV	lete etter; søke; sakne; savne	s3,s4,a1,dej
ohtsedidh	V	lete; lete etter; finne frem	s1,s2,s3,dej,åa5,a1
ohtseme	søknad	s4
ohtsemebiejjie	søknadsfrist (dag)	s2
ojhte	nettopp; jo visst (som ventet); altså	s2,åa5
okse	dør	dej
okse	dør (i hus)	dej
oktebisnie	alene; for seg selv	dej
oktegh	alene	s1,s2
olkese	ut	s2
olle		a1
onne	liten	s2,dej,åa5
onne-gåetie	WC; do; toalett	a1
orre	ny; nytt	s1,s2,dej,a1
orregåetie	nyhus	s2
orrijidh	V	slutte	dej
ostedalledh	V	fordrive tiden; ta det med ro	s3
otnerasse	hver av de fire krumme stengene i gammeskjelettet	s4
ov	aldeles; riktig	åa5
ov jösses	”du store min”	s2
ov nimhtie	slik	s3
ov-juvre	udyr	s3
ovmese	forskjellig	s3,åa5
ovmessie	atskillig; ymse; litt av hvert	a1
paahke	pakke	s1
paajsanidh	V	komme seg unna; dra fra sted til sted; holde seg avsides	dej
paanne	stekepanne	s3,dej
peara	potet	dej
peehkedh	V VI	pakke; sette av sted	dej
plaave	blå	s1,s2,dej,a1
plaerie	avis; blad	s3
pliejhkies	blek; blass; falmet	s4
pluevie	myr	dej
pluevie-bealese	til ved siden av myra	dej
plusse	pluss	s1,a1
plåahkodh	V II	være nødt til å skratte for det er så komisk	dej
plïehtje	flat; slett	s3,s4
plïehtje-gaerie	tallerken	s3
praare	bratt	s4
praare deava	bratt bakke	s4
pradtjedh	V IV	ta i; gjøre kraftanstrengelse	s4
prievie	brev	s1,s3,dej
provhkedh	V IV	bruke; benytte; pleie; pleie å ha	s2,s3
provne	brun	a1
provnedh	V IV	tvinne sammen	s4
pruvredh	V VI	gifte seg	s2,s3,s4,dej
pruvres	(er) gift	s2
pruvrese	brud	s4
pruvvie	bru	s2
pryövedh	V V	prøve; forsøke	dej
prïejhke	preken	s3
prïhtjege	kaffe	s1,s2,s3,dej,åa5,a1
prïhtjegh	kaffebønner; malt kaffe	s2
prïhtjh-giebnie	kaffekjele	s1,dej
prïhtjh-gåetie	kafé	s1,s3
påaske	påske	s4
påaste	post	s3,dej
påastegåetie	posthus	s1,a1
pæhperh	pepper	s4
raadtehts	den ytterste tarmen med tynt innhold	dej
raahkeldidh	V	fare og farte; rakle	åa5
raahkoestidh	V	fiske under isen	s4
raajedh	V IV	sende i veg; beordre	dej
raajne-vaarjoe	reine klær	s3
raakte	endog; nesten	s3
raarahtalledh	V	rådslå	dej
raarhkeme-stuhtje	skiftingsrein	dej
raarhkoe	reinskilling	dej
raavre	røye	s2,s4,åa5
raavtedh	V IV	få kraft (om bark) og virke godt (om barkelåg)	dej
raavtehtje	kraftig; som trekker godt inn (om bark; barklåg)	dej
raavteres	kraftig; som trekker godt inn (om bark; barklåg)	dej
radijove	radio	s3
radtjoes	rask; effektiv	s2
raedtehke	hund (som er flink til å passe kanten av reinhjorden)	dej
raedteste	fra kanten	s1
raeffie	fred	s4
raejkie	hull	s4,dej
raejkie-baenie	hulltann	dej
raerhkedh	V I	skifte; skille rein	dej
raerie	råd	s4
raerievedtije	rådgiver	a1
rahka	november	s2,a1,dej
rahta	tett granskog; granli; tett skogslandskap	dej
rahtjedh	V IV	trekke i en bestemt retning ( f.eks om rein som vil tilbake der den har vært før)	dej
rastah	over; tvers over	dej
ravve	bak (på menneske)	s3
reakadidh	V	fødes	s2,a1
reakedsbiejjie	fødselsdag	s2,a1
reaktoe	rett (til); sant	s1,s2,s4,a1
reejnedh	V VI	renske; fli opp	s4
reejredh	V VI	tordne; bråke; leke støyende (om barn)	dej
reektedh	V VI	skrape (skinn)	dej
restiedidh	V	føre; drive (reinhjord) over elv eller pass	dej
riehpene	ljore; røykehull	s4
riejries	ferdig; klar; reiseklar	s2,s3,åa5
riepie	rev	dej
rihkijahtjedh	V	begynne å gå i brunst	dej
ringkedh	V VI	ringe; telefonere	s1,s2,s3,dej
risjnedh	V VI	sanke ved	dej
risnjedh	V IV	sanke (sammen småved)	s3
rissie	yr; fint regn; småregn	s3
roehtedh	V IV	løpe; springe ( på toom mennesker og fugler)	dej
roevtedh	V IV	bli solbrent	s4
rohtedh	V	sette inn med styggværsnøstorm	s3
rovnegs	underlig; rar	s3
rudtje	rygg	s2,s3
ruerhkie	det tynne av blodet	s4
ruevtie	jern (stykke)	s3
ruevtie-raajroe	jernbane	s1,s3,dej
ruffie	juni; røytemåned; pelsskifte	s2,a1,dej
ryöhkedh	V V	rekke til; nå; være (om tid)	s3
ryöjnesjidh	V	gjete	a1
ryöjnesjæjja	gjeter	a1
ryöjredidh	V	gjøre seg ferdiggjøre seg reiseklar	s2,dej
ryöknedh	V V	regne	åa5
råahke	kastrert reinsbukk	dej
råakedh	V IV	møte; treffe; treffe (en person)	s2,s3,dej
råakodh	V II	bjeffe (om rev)	dej
råanedh	V IV	tjuvpatte (om reinkalv)	dej
råanjedh	V IV	sile ned; pøsregne	s4
råantjoe	kastrert reinsbukk; trekkrein	dej
råatedh	V IV	brake (om is)	dej
råavedh	V IV	lete etter simle (om kalv)	dej
råavkedh	V IV	grynte ( om simle og kalv)	dej
råhtoe	tett granskog; granli; tett skogslandskap	dej
råtnoe	gjeldsimle	s3
ræhka	mislykket kastrat	dej
rïekte	rett; bein	s3
rïesegh	blomster	s4
rïevtje	kaldt vær med regn (styrtregn)	s3
rïhkedahke	paringstid; brunsttid	dej
rïhkede	paringstid; brunsttid; oktober	dej
rïhkijidh	V	begynne å gå i brunst	dej
rïhpestidh	V	lukke opp	dej
rïhpestidh	V	åpne	s3
rïjtedh	V VI	putte; stikke; stikke (noe f. eks inn i en sekk)	s1,dej
rïrresjidh	V	gnu inn bark (på skinn)	dej
röödtsedh	V VI	rote og grave	dej
röönjedh	V	rydde ( eks. kåteteltplass)	åa5
rööpses	rød; rødt	s2,dej,a1
röövre	børste	s4
saajkardahke	spile for skinn (den går langs siden på skinnetto på hvert skinn)	dej
saajkardidh	V	spile skinnet langs sidene med saajkardahkh	dej
saajve	underjordisk vesen; hjelpeånd	s4
saakoe	sag	åa5
saalehte	fangst	s4
saalme-gærja	salmebok	s3
saarnoeh jeahtah	i alle dager; hva i all verden sier du	s1,s3
saatnan	sant	s3
saehtedh	V I	frakte; føre; sende i vei	s4,dej
saejmie	søm	dej
saejrie	sei	s3
saejriedidh	V	smerte; gjøre ondt; verke	s2
saelhtie	salt	s1,s2,s3
saemesth amma	snakk samisk	s1
saemie	same	s2
saemiedigkiepresidente	sametingspresident	a1
saemien	samisk	s2
saemiengïele	samisk språk	a1
saemiestidh	V	snakke samisk	s1,s2,a1
saernie	nyhet	s3,dej,åa5
saevrie	våtløs og grov snø om våren	s4
samhkedh	usikkert vær (pga. sotrøyk)	s3
sarva	grarein; brunstig rein	s1
satne	han; hun (tilbakevisende)	dej,åa5
seadtoes	fredelig	s3
seahkoe	klov (av rein og hornkveg)	dej
seahkoe-måarah	knoklene i kloven	dej
seahkoe-voeje	fett kokt av klover	dej
sealkedh	V III	lande (om båt)	dej
seamma	det kan være det samme; samme; like	s2
seangkoe	seng	s3,a1
seasa	faster; fars kusine; en fars faster; en mors faster	a1
seedtedh	V VI	sende; kaste	s3,dej
seenhte	sent	s2
seeptjedh	V VI	samle; koste; feie; gjøre (flyttveg) klar	dej
sermie	småskog og kratt	dej
sesnie	skinn som er lagt til for avhåring	dej
siekierdidh	V	ha lyst på noe bestemt (spiselig)	s3
sietedh	V I	føre; drive( en flokk)	dej
sigkedh	V VI	trekke; dra; rykke	s4,a1
sih	de (kortform av sijjieh)	s2
sijjie	plass; sted	s1,s2,s3,dej
sinsitnien	hverandre	dej,åa5
sirrie	blåbær	s4
sisnie	inne i; i	s3,a1
sjaampove	sjampo	s3
sjalkedh	V III	smelte; tine; bråne	s4,dej
sjeakodh	V II	rydde	a1,dej,åa5
sjeavodh	V II	stille; på lydløs måte	s4
sjeavodslaakan	stille; på en lydløs måte	dej
sjelhkiedidh	V	tulle; tøyse; spøke	s4
sjeltie	by; kirkested; marked; stevne	s1,s3,dej
sjiehteles	passende; liketil; høvelig	s3
sjilhkehtidh	V	smelte snø; fett	s4
sjovne	tjenestejente; taus	a1
sjuevnjede	mørkt	s3
sjyjjedehtedh	V	glatte ut; gjøre jevn	dej
sjyjjehke	glatt og jevn	dej
sjåarhtoe	skjorte	s1,a1
sjåavoehtidh	V	røre om; røre	s3,dej
sjædtojste dïeves	her; overgrodd av gress; overgrodd av planter	s4
sjæjsjalidh	V	endelig beslutte seg til noe; påta seg noe	s3
sjïdtedh	V IV	bli; vokse; må; måtte	s2,s3,dej
sjïehtedh	V IV	passe; høve; være høvelig	s3,dej
sjïehteles	passende	dej
sjïere	særskilt; for seg	s2
skaanjedh	V IV	single; klirre	dej
skaarja	saks	s3
skaavhtege	kasse; oppbevaringsboks; kantet; skap	s2,s3
skeeledh	V VI	skrelle	s4
skeeredh	V	feie hornene	dej
skeerestidh	V	begynne å feie hornene	dej
skeerkedh	V VI	klarne	dej
skiblie	fiskeskjell	s3
skiehrie	kinn	s3
skilkedh	V VI	ødelegge	s2
skilledh	V VI	vende mot varmen	dej
skirhmedh	V VI	ødelegge	dej
skitjskiestidh	V	storle	dej
skodtedh	V IV	skynde seg	s3,s4,dej
skodth varki	skynd deg	s3
skovhte	skyss	s4
skovtere	skuter	s1
skreepedh	V VI	skrape	s3,dej
skreepestidh	V	skrape (fort)	s4
skruvve	skruv	s3
skubpedh	V I	gni; rubbe; pusse (tenner)	a1
skugkie	skygge; gjenferd	s4
skuvle	skole	s1,s2,dej
skuvledh	V VI	skylle	s3,dej
skuvtere	skuter	s2,s3
skåape	skap	dej
skåerrie	barket skinn (uten hår)	dej
skïemmenidh	V	ta skade	dej
skïemtjes	syk	s2
skïeredahke	brunsttiden; parringstiden	dej
skïerede	september; brunsttid; parringstid	s2,a1,dej
skïeredh	V IV	parre seg (om rein)	a1
skïereme-sarva	grarein som har feiet hornene	dej
slaahpoe	ryggsene ( den store ryggsen på rein)	dej
slaahpoe-soene	ryggsene	dej
slaavtje-guelie	fisk som nettopp har gytt	s3
slahkode	på skrå	s4
slahtjan	ødelagt; i ustand; i stykker; gått i stykker (må repareres)	s2,s3
slahtjegidh	V	gå i stykker; bli ødelagt	s3,s4
slajkedh	V III	løsne	dej
slapmoeh-gåetie	lav og vid gamme	s4
slavtje-guelie	fisk som nettopp har gytt	s3
sleagran	skitten; veldig skitten; tilgriset	s3
slearodh	V II	slenge; kaste(flere ting)	dej
sleegkedh	V VI	legge i bakken (kalv som skal merkes; grarein som skal kastreres)	dej
sleehpedh	V VI	spinne senetråd av ryggsene	dej
sleehpeldihkie	er spunnet av ryggsener	dej
sleengkedh	V VI	kaste	åa5
sleevhkedh	kaste; slenge fra seg	s4
sliehtie	sludd; sklette	s3,dej
sliehtie-elmie	ruskevær med sludd	s3
slognestidh	V	lyve	s3
slonhterdidh	V	drive dank og ingenting gjøre; være fri	dej
sluekieh	hoderinnvollerblod m.m ( av dyr som slaktes)	dej
sluvke	sluk	s4
slyöhpedh	V V	slippe (å gjøre noe)	dej
slærra	slede	s2,s3
slïehtehke	snøspurv; sletthøvel	dej
slïekte	slekt; slektning	s1,s2,s3
slïekti luvnie	hos slektningene	s2
slïmhpe	munnsår	s4
smeejvedh	V VI	partere (slakt)	s3,dej
smååhkedh	V V	smake; smake på	dej,åa5
snaejrie	skive	dej
snarredh	V IV	rynke (når en syr)	dej
sneehpes	snar	s4,åa5
snjaltje	juli; avrøtt hår (om skinn); snauslitt (om skinn)	a1,s2,dej
snjipkedh	V VI	slippe løs; spenne fra	dej
snuehtie	nygress; første gras-spirer om våren	s4
snåvhtoe	en dukke skohøy; skohøytotter	s4
snæhkere	snikker	a1
snööledh	V VI	beite litt; nappe litt her og der	dej
soejmi	sakte	åa5
soen'-åedtjie	ryggfilet; kjøttet langs ryggen på slakt	dej
soene	sene; senetråd	dej
soerme	finger	s3
soeve	røyk	dej
soevestaahke	røykt kjøtt	dej
soevestehtedh	røyke kjøtt; røyke fisk	dej
soevestidh	V	røyke (fiskkjøtt)	s3
soevine	skitten 	s3
sohkerelaejpie	sikkerbrød	s1
sohpedh	V IV	skave; spise kjøttbein reint	dej
sojjedh	V IV	bøye seg; tøyes	s4
sommedh	V IV	hviske; snakke lavt	dej
soptsestidh	V	fortelle; snakke med noen	s2,s1,s3,dej,a1
sovhtine	(er) forkjølet	s2
sovkedh	V IV	ro; gynge	dej,åa5
sovkijahtjedh	begynne å ro	åa5
sovkije	roer	åa5
sovmedh	V IV	anta; ha mistanke om	s2,s3,s4,dej
spaajhte	fort; lett; hurtig	s4
spaajhte	hurtig; rask	dej
spaanesh-ræhkere	sponhøvel	dej
spaarra	spile	dej
speenedh	V VI	legge spon på bellinger	dej
speerredh	V VI	spile (skinnkjøttfisk til tørking)	dej
spijhkierdidh	V	spikre opp	s4
spååredh	V V	spare	dej
spæjhkere	spiker	åa5
staajne	gjeldsimle; simle som aldri får kalv	dej
staare	by	dej
staeries	stødig; stadig; riktig; rett	a1,dej
stasjovne	stasjon	s3
steeblege	støvel	a1
steegkedh	V VI	stenge; lukke	s4,dej
steeredh	V VI	holde	dej,åa5
stilledh	V VI	sette en til å gjøre noe; tilsi	dej
stoenedh	V IV	legge uti; hoppe i elva (om et dyr eller en flokk)	dej
stoerre	stor	s2,s3
stoerre-dålle	stor varme	s3
stoerre-giebnie	storkjel	dej
stoerregeajnoe	storveien	s2
stovle	stol	s3,dej
straavvedh	V IV	være bekymret; nære mistanke; tvil	s4
strerkiestidh	V	være engstelig; bekymret	s4
struvkestidh	V	rykke; rykke til	åa5
stræjja-voesse	strisekk	dej
stujmie	bråk; larm; leven	s4
stuvredh	V VI	styre; styre i riktig retning	dej
ståapoe	hus; stue	s2,s3
ståvroe	styre; råd	s4
stååkedidh	V	leke	s2
stænkodh	V II	bli sterk; fast	s4
stïeres	som er til stede; stødig; ferdig tilberedt 	s3
suehpede	kalvingstid; mai	s2,s4,dej,a1
suehpede-baelie	kalvingstiden; den tid da de fleste simler kalver	dej
suehpiehtidh	V	kalve ( om simler)	dej
suejies	i ly for vinden	s4
suejnie	høy; skohøy; skohøy (sennegress)	s4,dej
suejnietjuahpa	sted for skjæring av skohøy	s4
sutnjien	til seg	s3
suvhpie	asp	dej
svaalnoe	svalt vær (straks etter solnedgang)	s3
svaaloe	kjølig vær (svalt)	s3
svaejlehke	reinokse under første året etter kastrering (men med hornene i behold)	dej
sveehkestidh	V	ta av; ta av (fra sti); vike til side som snarest	s2,s4
svååredh	V V	svare	dej
svæjmadidh	V	besvime; falle om	s4
sygkesidh	V	bli trukket (ut; opp osv)	dej
syhtjegh	sjustjernene	dej
syjhtedh	V V	passe barn; passe syke og eldre mennesker	dej
sysngelasjh	innmat; innvoller	s3,s4
såafoe	område med løvtrær	s4
såahpodh	V II	kalve (om simler)	dej
såajmanidh	V	sakne på farten	åa5
såajoe	lunt; vindfritt sted	s4
såataskidh	V	drukne ved å gå gjennom is	dej
såekie	bjørk	dej
såeleme	spire (på horn)	dej
såelie	finne (på fisk)	dej
såemies	en eller annen	dej
såevlie	snøsørpe på is; issørpe	dej
såevmie	tørtfint beite under snøen	s4
sån	vel; uttrykker formodning eller forundring	s1,s2,s3
såvnjodh	V II	ryste (sengklær); banke snø av klær	dej
såvrodh	V II	surne; bli sur	dej
sååjhtedh	V V	treffe til; høve; komme til å (gjøre noe)	s3,dej
sååle	øy; holme	dej
såålhtedh	V V	salte; salte ned	s3,dej
såålhtehke	salt (tilført)	s3
såångedidh	V	fri	s4
såångedæjja	frier	s4
såårnedh	V VI	fortelle; meddele	s4
sægkodh	V II	trekke ut	dej
sæjjoesdålle	åpen varme	s4
sæjlodh	V II	blitt trett; sliten	dej,åa5
sæjloes	trett; sliten; utmattet	s2
sïejme	fiskesnøre	s3
sïejpe	ulv	dej
sïelkedh	V IV	gli mot land (om båt)	åa5
sïerrenohke	fremmed	s2
sïesele	tantebarn på farssiden	s4,a1
sïjhtedh	V IV	vil; vil ha; ville; ville ha; ønske; ville være s1,s2,s3,a1,dej,åa5
sïjse	inn i	åa5
sïjte	sameby; reindistrikt; samegruppe	dej
sïlle	skritt; favn (lengdemål)	s1,dej,a1
sïlpebeetnege 	sølvpenge	s4
sïlpevæhta	sølvmedalje (merke)	s4
sïmmedh	V IV	hviske; snakke lavt	s4
sööjmes	sein; treg	s3
söönedh	V VI	trekke ut sener av reinsfot	dej
sööpedh	V VI	feie; koste	dej,åa5
tabledth	tabletter	s2
taxi-sijjie	taxi-sentral	s4
teatere	teater	s4
tellefovne	telefon	a1
tellefovnenummere	telefon	s1,a1
tjaakanidh	V	få plass; rommerommes	s2,s4
tjaaleldh	skriftlig (skrevet)	s4,a1
tjaalestidh	V	snitte opp (skinnet under flåing)	dej
tjaangedh	V IV	gå inn; stige på; dra ned i skogsbandet (om rein)	dej
tjaebpies	fin; fine; vakker; pen; skjønn	s1,s2,s3,dej
tjaebpieslaakan	på en fin måte	dej,åa5
tjaeledh	V I	risse; skrive	s1,s3,dej,a1
tjaelije	forfatter	a1
tjaetsie	vann	s1,s3,dej,a1
tjagkeredeava	tørrlende; tørrfast mark	s4
tjahkasjidh	V	sitte	s2,s3,s4,dej,åa5
tjahta	kilo	s1
tjahtedh	V IV	kreiste; ta i	dej
tjaktje	høst	s4,dej,a1
tjaktje-daelvie	høstvinter	s4
tjaktje-giesie	høstsommer; sommerhøst	s4,dej
tjaktjege	om høsten	dej
tjalmese	nettmagen	dej
tjarke	hardt; kraftig	dej,åa5
tjarve	skare som bærer	s4
tjeallere	kjeller	s3
tjeapohke	hals	s3
tjeapohkelijnie	halstørkle	s2
tjearodh	V II	gråte	dej
tjeavla	garnkavle; garnduble	åa5
tjeavla-gierkie	garnstein	åa5
tjeavla-rietjmie	kavlesnor	åa5
tjeehpes	svart	s2,a1
tjelmehts	blind	s4
tjelmie	øye	s3
tjengkere	ball	s3
tjerkie	skinnet mellom klovene; nederst del av belling	dej
tjetskehke	nysgjerrig	s3,dej
tjevties	fast i kjøttet (om fisk)	s3
tjidtjie	mor	s1,s2,dej,a1
tjiehpies	hendig; flink; dyktig	dej
tjiehtjele	rom	s2
tjiehtjere	tå	s3
tjiermie	nyre	s3
tjietsie	ens fars yngre bror; ens fars yngre fetter a1
tjietsuve	en manns eldre brors sønn; en manns eldre brors datter	a1
tjihkedidh	V	sette seg	dej,åa5
tjihtedidh	V	trenge seg fram; klemme seg mellom noe; trenge seg inn	s4
tjimkedh	V VI	legge kløv	dej
tjirkedh	V VI	forsikre; våge	s3
tjoehpedh	V IV	hugge; skjære	dej,åa5
tjoehpestidh	V	skjære litt; hugge litt; klippe litt; skjære av	s3,dej,a1
tjoeje	stemme; tone	s4
tjoejhke	mygg	s3
tjoejkedh	V IV	gå på ski	s1,s2,a1,dej
tjoejkedidh	V	holde på å gå på ski	a1
tjoejkegåetedh	begynne å gå på ski	s4
tjoele	såpe	s3
tjoemehtidh	V	be; trygle	s4
tjoeredh	V IV	måtte	a1,dej,åa5
tjoermedh	V IV	be til Gud	s4
tjoermehtasse	bønn	s4
tjoeveridh	V	måtte	s2,s3
tjoevtenje	nøkkel	s3,s4
tjogneh	saker og ting	s1
tjohpe	lue	s3,a1
tjohtjedh	V V	hige etter; strebe etter	dej
tjonkedh	V V	pakke ut; rydde opp	dej
tjonne	tjern	dej
tjorme	fjorårskalv	s2
tjovle	kjole	a1
tjovrese	nakke	s3
tjovve	spiserør; matstrupe; svelg	s3,dej
tjuedtjielidh	V	stå opp	s2,a1
tjuetie stoerretjuetie	hundre tusen	s2
tjuevtjiedidh	V	peke	åa5
tjulhte	sil	dej
tjulhtedh	sile	dej
tjuvliestidh	V	kysse	s4
tjuvviestidh	V	regne inn gjennom ljorehullet	s4
tjåadtjodh	V II	stå	s2,dej
tjåadtjoestidh	V	stå litt 	s3
tjåagka	gaffel	a1
tjåagkedh	V I	røve reinkalv (om ørn; ta; stjele	a1,dej,åa5
tjåagkodh	V II	karve; skjære eller hakke med knivspiss; karve bort bark med kniv	dej
tjåalhte	lite fjell; knaus	dej
tjåalodh	V II	sløye flere fisker	s3
tjåanghkan	sammen	dej
tjåanghkenidh	V	samles	s3
tjåanghkoe	møte; samling	s2,s1,a1
tjåanghkoeh	bunt	dej
tjåanghkoetjïehtjele	møterom	s1
tjåarvodh	V II	rope; rope på; kalle på	dej
tjåegkedh	V I	samle; plukke	a1
tjåejjie	mage; magesekk	s3,dej
tjåelieh	innmat av fisk	s3
tjåenieh	eiendeler; husgeråd; bagasje	s3,åa5
tjåentjeme	øvre margbein i bakfoten på rein	dej
tjåervie	horn; horn (på rein osv.også sneglehus; horn som materiale); krone	s3,dej
tjåetskeme	kaldt vær; kulde	s1,s2,s3,dej
tjåhkodh	V II	kjemme; kamme (skohøy)	s4,dej
tjåhkome	redskap til å kamme skohøy	s4
tjååhpedidh	V	bli svart; bli formørket	s4
tjïehtjele	rom	s3,a1
tjïektjedh	V IV	sparke; spenne; slå (om puls)	s3,dej
tjïektjes-juelkie	bakfot	s4,dej
tjïelkestimmie	forklaring	s1
tjïeltekontovre	kommunekontor	s4
tjïerte		a1
tjïeskedh	V IV	kløyve	s3
tjïjhtje	sju	s1
tjïjhtjede	sjuende	s1,s2
tjïrredh	V VI	sote til	dej
tjöödtjehtidh	V	stoppe opp litt; bli stående	s2,s3
tjöödtjestidh	V	stanse; stoppe opp litt; bli stående	s2,dej
tjööjjeste	kvalme	s2
tjööke	kjøkken	s2,s3
tjöönghkedh	V VI	samle; plukke	s3,dej,åa5
tjöönghkeme	plukket; samlet	s2
tjöönghkesovvedh	bli plukket	åa5
tjööse	rein med hvit snute; hvitflekket hode; lys rein	s3
traktovre	traktor	s2,s3
trimhkeldahkesne	lukket igjen	s4
tryjjedidh	V	trives	s2
tryöjjadidh	V	trives	s3
tryöjjes	trivelig; hyggelig	s3
tråahpe	trapp	s4
tråajjoe	trøye	s3
træjpoe	stridt vær (strid vind og regnsludd eller snø)	s3
trïengke	dreng 	s3,a1
tsaekedh	V I	putte; stikke inn; ta på seg klær; drive (rein inn i gjerdet)	dej
tsaepmedh	V I	slå; banke (skohøy)	dej
tsagkedh	V IV	spenne ut; spile (skinnskallerløpemage); pakke (i sekk); træ (f.eks fiskegarn på garnstikke) 	s3,dej,åa5
tsagkeldh-dueljie	spilt skinn med spaarrah	dej
tsagkeme	pakket (i sekk); puttet forskjellige ting i noe	s2
tseagkoeh-gåetie	opprettstående gamme; kåte uten otnerasse	s4
tsebpie	leggbein på reinens framfot	dej
tseegkedh	V VI	sette opp; reise opp; bygge; sette på (kjøttgryte)	s4,s2,s3,dej
tsegkie-deakehke	strange med utspring	s4
tsietsedh	kneppe i reinens klover	dej
tsiptsedh	V I	knipe; klype; klemme	dej
tsoedtse	kjøtthinne; kjøttslintre	s4
tsoevtse	snøbre	s3
tsumhtsie	rusk; boss	åa5
tsuvvedh	V I	trave; springe med lange skritt (om reinhest)	dej
tsyögkesidh	V	reise seg (om håret på hund når den blir sint)	dej
tsåahka	klokke	s1,s2,a1
tsåakodh	V II	falle; synke ( om vannstand)	dej
tsåalhkodh	V II	hamre; pikke; hakke (om fugl)	dej
tsåapkodh	V II	brytebrekke i stykker (flere ting)	dej
tsåaptsele	som holder seg på plass	s4
tsïengele	januar; isklangtiden	s2,a1
tsïnne	kjønnsorgan (kvinnelig)	s3
tsööpkedh	V VI	bryte av; brekke	dej
tsøøpkedh	brekke av; slå i stykker; bryte ned	s4
tuhtjedh	V VI	mene; tro; synes 	s3,dej,åa5
tyjje	stoff; tøy	dej
tæjmoe	time	dej
uktsie	ni	s1
ussjedidh	V	tenke (over); akte å gjøre noe; fundere	s2,s3,dej
ussjedimmie	tanke	dej
utnedh	V I	ha; bruke	s3,dej,åa5
vaadtsajidh	V	gå i veg; gå avsted
vaajese-gærja	fortellerbok	s4
vaajmoe	hjerte	s4,s3
vaajtelidh	V	ønske	s3
vaaksjodh	V II	se til; undersøke; besøke	dej
vaalje	åpning i terrenget; glenne	s4
vaanghka	kjøttet på reinens bakfot	dej
vaanghka-klivvie	haseledd	dej
vaanghka-måara	haseknoke på rein (alle småbeina i hasen på partert rein)	dej
vaanhtse	vott	a1
vaarjelidh	V	forsvare; beskytte; bevare	dej
vaarjoe	klesplagg	s2,a1
vaarjoeh	klær	s2,åa5
vaarjoevåarhkoe	kleskap	s2
vaarredh	V IV	gå; springe; løpe	dej
vaarrestidh	V	gå; bevege seg	s3
vaasedh	V I	passere; gå forbi; gå (om tid)	s3
vaedtsedh	V I	gå	s1,s2,s3,dej,åa5
vaejlie	feber	s2
vaejsjie	ulv (udyr)	s3
vaejvie	smerte; bekymring; sjelelig lidelse	s4
vaeknie	våpen; ammunisjon	s4
vaeltedh	V I	ta	s1,a1,s2,s3,dej,åa5
vaeltjehke	gammel dreven reinskar	s3
vaenie	lite; noe det er knapt om	s2,s4,s3
vaerhpiedidh	V	slenge ut not	s4
vaerie	fjell	s1,s2
vaeriej dubpelen	bortom fjellene	s4
vaerieståapoe	fjellstue	s2
vaesedh	V I	passere; gå forbi; komme ut av syne	s2
vaestiedidh	V	svare	a1
valkedh	V III	dra; reise samlet avgåre ( om rein)	dej
valkedh-okse	stor åpning i et reingjerde der flokken slippes ut/drives inn	dej
van	så	åa5
varke	fort; snart	åa5
varkedh	V III	komme seg (av tretthet)	dej
varki	fort; snart	s3
varres	frisk; fersk (om kjøtt)	s3
veajedh	V III	gli; gli av	dej
veaksehks	sterk	s4
vealasjidh	V	ligge på siden; ligge eller sitte; lent til noe (f.eks. til albuen eller mot hånden)	s2,s3
veana-soene	sene med beinknapp i bakre leggbein	dej
vearadidh	V	være (noenoen sted)avlegge et besøk	s3
vearelde	vær	s2,s3,dej
veartene	verden	a1
veaskoe	veske	s3
veasodh	V II	leve; oppholde seg; bo; ekstistere	dej
veasome	liv; levned	s2
vedtedh	V I	gi	s1,s3,s2,dej
vedtiestidh	V	gi; gi som snarest; gi litt	a1
veedtjedh	V VI	hente	dej
veeljedh	V VI	velge	s3,dej
veelkes	hvit	s2,s3,dej,a1
veelle	gårdsplass; åpen plass	åa5
vervesne	(er) rørlig; frisk	s4
vervies	frisk; rørlig	s3
viedtedh	V I	binde fast; tjore	dej
viehkie	hjelp	s3,s2,dej,a1
viehkiehtidh	V	hjelpe; hjelpe til	s3,s2,dej,åa5
viehkiehtæjja	personal; hjelper	s4
vielie	til (i tillegg); mer; (med nektelse) lenger	s2,s3,s1,mer
viere	ring av sammensnodde skohøydotter	s4
viermie	fiskegarn	dej,s3,s4,åa5
viertedh	V I	felle (tre); hugge ned	dej
vietjere	hammer	åa5
vietseles	triveliglikesæl; grei; vennligsinnet	s4
vigkie	strid; uenighet	s4
vihkeles	viktig; formålstjenlig	s3
vihth	atter; igjen	s1,a1,s3,åa5
vihth masten	til forveksling	s4
vihties	sikker; med sikkerhet	s3
vijhtsierdidh	V	kvitre (om fugler)	s4
vijne	vin	s4
viskes	gul	a1
vissjedh	V IV	orke; gidde	s4,dej
vissjeles	tålmodig; flittig; utholdende	s4
vitnedh	V VI	vinne; overvinne; greie; få tid til	s3
voedtege	skoband	s3
voeje	smør	s1,a1
voejedh	V IV	svømme	dej
voejhkelidh	V	prøve (å gjøre noe); ta fatt	s2,s4
voeksedidh	V	kaste opp	s4
voektenje	garnsule; gisne; stillas til å henge; tørke garn på	åa5
voeledh	V IV	spikke; spikke til	dej
voelpetje	lille venn	s4
voene	bygd	dej,åa5
voepth	hår	s3
voeresgåetie	eldresenter	s4
voerhtje	april; kråke	s2,dej,a1
voerkedahke	tiden da reinen feier hornene ( i tiden ca 20.aug - 10.sept )	dej
voesse	sekk	s1,s2,s3,dej
voessetje	liten sekk	s3
voessjedh	V IV	koke	s2,s3,a1,dej
voestegh	først	s1,s2,åa5
voestes	første	s1,s2,åa5
voestes gietjeste	i førstningen	s4
vuajnajidh	V	få øye på	dej
vuarhkeme-sarva	grarein som har feiet hornene	dej
vuartasjidh	V	se på; betrakte; se etter; passe på	s2,s1,s3,dej,åa5
vuasta	ost	s1,a1
vuebnie	ovn	s1
vuehtedh	V I	spore; spore opp; følge sporet	dej
vuejedh	V I	kjøre	s1,s2,s3,dej,a1
vuejemeleahpa	sertifikat; førerkort	s2
vuejije	sjåfør	s1,s2,s4,a1
vuejnedh	V I	se	s2,s3,dej,åa5
vuekie	skikk; bruk; måte	dej
vuelelen	nedenfor	s4,dej
vuelie-raedtie	nedre kant; nederkanten (av noe)	dej
vuelkedh	V I	dra av gårde; reise (av sted); reise	s2,s1,s3,dej
vuelnie	nede	åa5
vuertedh	V I	vente	s3,dej
vuertieh ånnetji	vent litt	s4
vuertiestidh	V	vente litt	s3
vuesiehtidh	V	vise	s1,s2,åa5
vuesiehtimmie	forestilling; fremvisning	s4
vuetjedh	V I	skyte	s4,dej
vuhtsedh	V I	galoppere	dej
vytnesjidh	V	gjøre håndarbeid; arbeide med hendene(f.eks sy); forarbeide; lage noe	s3,dej
vyöhkesidh	V	hjelpe hverandre	dej
vyölkedidh	V	bli hvit; hvitne	dej
våajodh	V II	synke	dej
våarhkoe	skap; forvaring; gjemmested	s2,s3
våaroe	skift; tur	a1
våaroeh	varer	dej
våatjodh	V II	flyte opp (om fett)	dej
våhkoe	uke	s3,s2,dej,a1
vååjnedh	V V	synes; vises; sees; se ut (som)	s2,s1,dej
våålese	ned; nedover	s3,dej,åa5
væjkeles	flink; dyktig	s3,dej,åa5
værtoe	storm	s3
vætnoe	arbeid; håndarbeid	dej,åa5
vïedtje	vegg	s4
vïedtjedh	V IV	hente	s3
vïehkesadtedh	V IV	hjelpe hverandre	dej
vïelle	bror	dej,a1
vïenhtedh	V IV	tro; mene; anta; tenke	s2,s3,a1,dej,åa5
vïeredh	V IV	telgje (med øks); barke av	s4,dej
vïernge	marbakke; den øvre kanten av helling (ned mot elv)	åa5
vïernge-raedtie	kanten av marbakke	åa5
vïevtjedidh	V	sprelle; ligge og velte seg	s4
vïjhte	fem	s1
vïjhtede	femte	s1,s2
vïjjedh	V IV	skjære til; klippe til for søm	dej
vïjlelidh	V	kaste et blikk; se opp	dej,åa5
vïlledidh	V	strekke seg	åa5
vïssjedh	V VI	gidde; orke	s2
vïssjehtovvedh	bli lei	s4,dej,åa5
vïssjeleslaakan	på en tålmodig og utholdende måte	dej
vïtnedh	V IV	vinne	s4,dej
vöölle	veldig	s4
vöörhkedh	V VI	gjømme	dej
vöörhkelidh	V	gjemme (i en fart)	s3
vööste	i mot	dej
åabpa	søster	s1,s2
åabpedh	V IV	redde; berge	a1
åadtjestidh	V	fange inn; kaste med lasso	dej
åadtjije-bearkoe	beinfritt kjøtt	dej
åadtjodh	V II	få	s2,s1,s3,dej,åa5,a1
åahpenidh	V	bli kjent (med person); bli kjent (med veilandskap)	dej
åahpetjh	kjente	s3
åajaldehtedh I	glemme; ikke huske	s3,s2
åajsodh II	klare; makte; orke; overvinne	s2,s3,dej,åa5
åarjel-vearelde	sydlig vær	s3
åarjelsaemie	sørsame	a1
åarjelsaemien	sørsamisk	s1
åarjelsaemiengïele	sørsamisk språk	a1
åavroe	varm; hett vær (solvarme)	s3
åbrodh	regne	a1
åebrelen	til overs; sette til sides	s3,åa5
åehpies	kjent; kjente; kjenning	s2,s3,s4,dej
åejjie	hode	s3
åejjie-moere	den fremste av stengene som en hud spiles på	dej
åejjieh saejriedieh	hodet verker	s2
åejvie	leder; hovedperson	s2,a1
åelkie	skulder	s3
åelkies	høyre	åa5
åelkiesbielie	høyre side	s2
åemehke	avdød; salig; avdød mann eller kone	dej
åemie		a1
åenehks	kort	dej,åa5
åeredh	V I	sove	s2,a1
åeremesijjie	sovested; soveplass	s2
åeremetjiehtjele	soverom	s2
åeremevaarjoeh	sengklær	åa5
åeremevoesse	sovepose	s4
åerie	blodåre	s3
åesie	slaktrein; porsjon	s3,åa5
åesiestidh	V	handle litt	a1
åesiestimmielæstoe	handleliste	a1
åesiestæjja	kjøpmann; handelsmann	s2
åestedh	V I	kjøpe	s1,s2,s3,dej,a1
åktsede	niende	s1,s2
ålkene	ute	s1,s3
ålkode	utenfra	dej
ålkoe-okse	ytterdør	dej
ålkoelisnie	utenfor	s2
ålkone	ute	dej
ålloeabpese	ullgenser	s1,s3
ålma	mann	s3
ålma-voelpetje	mannlig venn	s3
ålvas	veldig; fryktelig	s3
ånnetji	litt; om men kort stund	dej,åa5
årra	hannrein	dej
årrodh	V II	være; bli (forbli); oppholde seg; bo	s2,s1,s3,a1,dej,åa5
åvte-bielie	framside	dej
åvte-gietjie	forende	åa5
åvte-nuelie	kjøttet på reinens framfot	dej
åvte-åejvie	de som styrer	s4
åvtehke	sjef	s4
åvtelen	før	s1
åvtelisnie	foran; lenger fremme	dej
åvtes-juelkie	framfot	s4,dej
åvtese	fremover	dej
åvtesne	førfør i tiden; tidligere	dej
åvteste	fra foran; i stede for; for	s1,a1,åa5
åågkesjidh	V	dufte godt	dej
åålije	saftig; velsmakende	s4
ååredæjja	ansikt	s3,dej
åårke	smal lang banke; flataktig landrygg	dej
ïedtje	mot; iver	åa5
övtebe	tidligere; forrige	s2,s3
ööhpehtimmie	utdanning; undervisning	s4
ööjeldihks	glemsom	s4
öörnedh	V VI	ordne; stelle i stand; lage	s4,s4
öövre	helt; aldeles	åa5
öövtebe	forrige	åa5
