marit adgjmpswyø
sissl behknqtwzå
toini cfiloruxæ


,
aabpelsijna --> abpelsijne (OK, endret)
baartes-våhkoe	ta vekk bindestrek, OK
baeniedåaktovre	--> baeniedåaktere,OK
baktie	--> baektie, OK
ballka	 --> baalka, OK
bearjedsaerede	tatt vekk bindestrek, OK
bearkoehkrovhte	--> bearkoekrovhte  s3: bearkoeh-krovhte ***
beensine	--> bensijne/bensïjne
biejjh-guaka	ta vekk bindestrek, OK
binte	(opprettholdt) OK
båatsoeh-bïenje	 --> riktig form er båatsoebïenje eller båatsoejbïenje ***
båirhketje	--> rett form er bïrhketje, OK
dåaktovre	--> dåaktere. Åa3: dåaktovre  ***  
eksamene	(oprettholdt)  --> eksaamene
fïerpenroehtse	denne er OK
gaale (fjernet)	
galkasaske (opprettholdt)	OK
gidtare	--> right form: gitaare (OK, endret)
glijredahke	--> riktig form tror jeg må være ‘plijrehtahke’ - noe som blinker (altså noe som er pent og skinnende) Forfatteren har brukt glijredahke, bør det endres?
gossehts denne er OK 	
gåetiessijjie	--> rett form er : gåetiesijjie (OK, endret)
gåårtjene	-->  right form: gåårtenje (OK,endret)
gïeth-gierehtse	
gïlmetahke	--> rett form er gilmehtahke (OK, feilversjonen av ordet er fjernet)
håagkhstaavra	--> right form: håagkstaavra  OK
jeeste	---> jeestere
jovkemsh	--> Riktig form er jovkemes (OK, endret)
kaaptejne	--> kapteene  åa6: kaaptejne *** ?
kilovmeter	--> kilomeetere   S2: kilovmeter ***  endret
kroehkememaasjina	??? vet ikke enda
kveita	--> kvæjta  OK
lahkoe		lagt inn som læhkoe, skrevet på denne måten i åa3:***
loevte-nidtjieh	--> loevtenjidtjieh - OK
minngeles-miesie  --> minngelesmiesie (OK, endret)	
muarjettjh	--> muarjetjh (OK, endret)
ov-juvre		denne er lagt til - OK  --> ovjuvre
radijove	---> radijovve
sjaampove --> sjampove (OK, endret)	
skubpehke	OK
soen'åedtjie	OK
spaaneshræhkere	--> spaaneserehkere
stasjovne OK	
suehpeds-dajve	--> uten bindestrek (OK, endret)
suehpeds-laante	--> uten bindestrek (OK, endret)
teatere	(oprettholdt)  --> teaatere
tjiehtjele --> tjïehtjele	OK
tjihkie-jovje	-->  uten bindestrek , OK
tjogneh	OK
urries-miesie		denne er lagt til - OK  --> urriesmiesie
viere	--> vïere
åeremetjiehtjele	--> åeremetjïehtjele - OK
åårganiste	--> organiste eller organïste
